scenario,drop_rate,seed,trial,entry_id,leader_term,start_ts_ms,commit_ts_ms,latency_ms
leader_crash_restart,0.00,0,1,1,1,305,401,96
leader_crash_restart,0.00,0,1,2,1,507,602,95
leader_crash_restart,0.00,0,1,3,1,712,805,93
leader_crash_restart,0.00,0,1,1,1,403,502,99
leader_crash_restart,0.00,0,1,2,1,607,703,96
leader_crash_restart,0.00,0,1,3,1,809,907,98
leader_crash_restart,0.00,0,1,4,1,911,1007,96
leader_crash_restart,0.00,0,1,5,1,1013,1109,96
leader_crash_restart,0.00,0,1,6,1,1120,1208,88
leader_crash_restart,0.00,0,1,7,1,1223,1309,86
leader_crash_restart,0.00,0,1,8,1,1324,1409,85
leader_crash_restart,0.00,0,1,9,1,1427,1509,82
leader_crash_restart,0.00,0,1,10,1,1529,1609,80
leader_crash_restart,0.00,0,1,11,1,1631,1709,78
leader_crash_restart,0.00,0,1,1,1,404,501,97
leader_crash_restart,0.00,0,1,2,1,1068,1104,36
leader_crash_restart,0.00,0,1,3,1,1210,1304,94
leader_crash_restart,0.00,0,1,4,1,2413,2508,95
leader_crash_restart,0.00,0,1,5,1,2617,2708,91
leader_crash_restart,0.00,0,1,6,1,2819,2909,90
leader_crash_restart,0.00,0,1,7,7,4832,4919,87
leader_crash_restart,0.00,0,1,8,7,6037,6124,87
leader_crash_restart,0.00,0,1,1,1,303,401,98
leader_crash_restart,0.00,0,1,3,7,3425,3512,87
leader_crash_restart,0.00,0,1,2,7,3425,3512,87
leader_crash_restart,0.00,0,1,2,1,528,604,76
leader_crash_restart,0.00,0,1,1,1,528,604,76
leader_crash_restart,0.00,0,1,4,1,528,605,77
leader_crash_restart,0.00,0,1,3,1,528,605,77
leader_crash_restart,0.00,0,1,6,1,528,605,77
leader_crash_restart,0.00,0,1,5,1,528,605,77
leader_crash_restart,0.00,0,1,1,1,301,401,100
leader_crash_restart,0.00,0,1,2,2,1330,1405,75
leader_crash_restart,0.00,0,1,3,3,4030,4113,83
leader_crash_restart,0.00,0,1,4,3,4131,4214,83
leader_crash_restart,0.00,0,1,1,1,405,502,97
leader_crash_restart,0.00,0,1,2,3,1618,1709,91
leader_crash_restart,0.00,0,1,3,3,1821,1910,89
leader_crash_restart,0.00,0,1,4,3,2024,2111,87
leader_crash_restart,0.00,0,1,5,3,2228,2312,84
leader_crash_restart,0.00,0,1,6,3,2413,2512,99
leader_crash_restart,0.00,0,1,7,3,2617,2712,95
leader_crash_restart,0.00,0,1,8,3,2820,2913,93
leader_crash_restart,0.00,0,1,9,3,3023,3115,92
leader_crash_restart,0.00,0,1,10,3,3226,3315,89
leader_crash_restart,0.00,0,1,11,3,3429,3516,87
leader_crash_restart,0.00,0,1,12,3,3632,3716,84
leader_crash_restart,0.00,0,1,13,3,3835,3917,82
leader_crash_restart,0.00,0,1,14,3,4018,4118,100
leader_crash_restart,0.00,0,1,15,3,4222,4319,97
leader_crash_restart,0.00,0,1,16,3,4431,4520,89
leader_crash_restart,0.00,0,1,17,3,4533,4620,87
leader_crash_restart,0.00,0,1,18,3,4635,4721,86
leader_crash_restart,0.00,0,1,19,3,4840,4922,82
leader_crash_restart,0.00,0,1,20,3,5024,5123,99
leader_crash_restart,0.00,0,1,21,3,5228,5323,95
leader_crash_restart,0.00,0,1,22,3,5432,5524,92
leader_crash_restart,0.00,0,1,23,3,5636,5726,90
leader_crash_restart,0.00,0,1,24,3,5839,5925,86
leader_crash_restart,0.00,0,1,25,3,5941,6026,85
leader_crash_restart,0.00,0,1,26,3,6043,6126,83
leader_crash_restart,0.00,0,1,27,3,6145,6227,82
leader_crash_restart,0.00,0,1,28,3,6248,6327,79
leader_crash_restart,0.00,0,1,29,3,6330,6427,97
leader_crash_restart,0.00,0,1,30,3,6432,6528,96
leader_crash_restart,0.00,0,1,31,3,6535,6628,93
leader_crash_restart,0.00,0,1,32,3,6636,6729,93
leader_crash_restart,0.00,0,1,33,3,6839,6930,91
leader_crash_restart,0.00,0,1,34,3,6941,7030,89
leader_crash_restart,0.00,0,1,35,3,7043,7131,88
leader_crash_restart,0.00,0,1,36,3,7246,7331,85
leader_crash_restart,0.00,0,1,37,3,7352,7431,79
leader_crash_restart,0.00,0,1,38,3,7434,7532,98
leader_crash_restart,0.00,0,1,39,3,7536,7632,96
leader_crash_restart,0.00,0,1,40,3,7638,7732,94
leader_crash_restart,0.00,0,1,41,3,7740,7832,92
leader_crash_restart,0.00,0,1,42,3,7842,7933,91
leader_crash_restart,0.00,0,1,43,3,7944,8033,89
leader_crash_restart,0.00,0,1,44,3,8045,8134,89
leader_crash_restart,0.00,0,1,45,3,8147,8234,87
leader_crash_restart,0.00,0,1,46,3,8249,8334,85
leader_crash_restart,0.00,0,1,47,3,8351,8434,83
leader_crash_restart,0.00,0,1,48,3,8453,8535,82
leader_crash_restart,0.00,0,1,49,3,8555,8635,80
leader_crash_restart,0.00,0,1,50,3,8656,8735,79
leader_crash_restart,0.00,0,1,51,3,8758,8835,77
leader_crash_restart,0.00,0,1,52,22,11874,13663,1789
leader_crash_restart,0.00,0,1,53,22,13765,13861,96
leader_crash_restart,0.00,0,1,54,22,13867,13961,94
leader_crash_restart,0.00,0,1,55,22,13969,14061,92
leader_crash_restart,0.00,0,1,56,22,14070,14161,91
leader_crash_restart,0.00,0,1,57,22,14173,14262,89
leader_crash_restart,0.00,0,1,58,22,14274,14362,88
leader_crash_restart,0.00,0,1,59,22,14376,14462,86
leader_crash_restart,0.00,0,1,60,22,14478,14563,85
leader_crash_restart,0.00,0,1,61,22,14580,14663,83
leader_crash_restart,0.00,0,1,62,22,14682,14763,81
leader_crash_restart,0.00,0,1,63,22,14783,14865,82
leader_crash_restart,0.00,0,1,64,22,14886,14965,79
leader_crash_restart,0.00,0,1,65,22,14987,15066,79
leader_crash_restart,0.00,0,1,66,22,15089,15166,77
leader_crash_restart,0.00,0,1,67,22,15171,15266,95
leader_crash_restart,0.00,0,1,68,22,15273,15366,93
leader_crash_restart,0.00,0,1,69,22,15375,15467,92
leader_crash_restart,0.00,0,1,70,22,15477,15567,90
leader_crash_restart,0.00,0,1,71,22,15580,15668,88
leader_crash_restart,0.00,0,1,72,22,15681,15769,88
leader_crash_restart,0.00,0,1,73,22,15783,15869,86
leader_crash_restart,0.00,0,1,74,22,15884,15969,85
leader_crash_restart,0.00,0,1,75,22,15985,16070,85
leader_crash_restart,0.00,0,1,76,22,16087,16170,83
leader_crash_restart,0.00,0,1,77,22,16188,16271,83
leader_crash_restart,0.00,0,1,78,22,16289,16371,82
leader_crash_restart,0.00,0,1,79,22,16391,16471,80
leader_crash_restart,0.00,0,1,80,22,16492,16572,80
leader_crash_restart,0.00,0,1,81,22,16594,16673,79
leader_crash_restart,0.00,0,1,82,22,16676,16773,97
leader_crash_restart,0.00,0,1,83,22,16777,16873,96
leader_crash_restart,0.00,0,1,84,22,16879,16974,95
leader_crash_restart,0.00,0,1,85,22,16980,17074,94
leader_crash_restart,0.00,0,1,86,22,17083,17174,91
leader_crash_restart,0.00,0,1,87,22,17184,17274,90
leader_crash_restart,0.00,0,1,88,22,17286,17374,88
leader_crash_restart,0.00,0,1,89,22,17387,17475,88
leader_crash_restart,0.00,0,1,90,22,17489,17576,87
leader_crash_restart,0.00,0,1,91,22,17590,17676,86
leader_crash_restart,0.00,0,1,92,22,17692,17776,84
leader_crash_restart,0.00,0,1,93,22,17793,17876,83
leader_crash_restart,0.00,0,1,94,22,17895,17976,81
leader_crash_restart,0.00,0,1,95,22,17996,18077,81
leader_crash_restart,0.00,0,1,96,22,18098,18177,79
leader_crash_restart,0.00,0,1,97,22,18200,18277,77
leader_crash_restart,0.00,0,1,98,22,18281,18377,96
leader_crash_restart,0.00,0,1,99,22,18383,18478,95
leader_crash_restart,0.00,0,1,100,22,18484,18578,94
leader_crash_restart,0.00,0,1,101,22,18586,18679,93
leader_crash_restart,0.00,0,1,103,26,20700,20790,90
leader_crash_restart,0.00,0,1,102,22,18687,20790,2103
leader_crash_restart,0.00,0,1,2,1,1003,1004,1
leader_crash_restart,0.00,0,1,1,1,1003,1004,1
leader_crash_restart,0.00,0,1,6,1,1003,1004,1
leader_crash_restart,0.00,0,1,4,1,1003,1004,1
leader_crash_restart,0.00,0,1,3,1,1003,1004,1
leader_crash_restart,0.00,0,1,5,1,1003,1004,1
leader_crash_restart,0.00,0,1,8,1,1003,1004,1
leader_crash_restart,0.00,0,1,7,1,1003,1004,1
leader_crash_restart,0.00,0,1,10,1,1003,1004,1
leader_crash_restart,0.00,0,1,9,1,1003,1004,1
leader_crash_restart,0.00,0,1,12,1,1003,1004,1
leader_crash_restart,0.00,0,1,11,1,1003,1004,1
leader_crash_restart,0.00,0,1,1,2,404,502,98
leader_crash_restart,0.00,0,1,2,3,406,502,96
leader_crash_restart,0.00,0,1,3,4,1339,1409,70
leader_crash_restart,0.00,0,1,4,5,1118,1205,87
leader_crash_restart,0.00,0,1,5,5,1962,2008,46
leader_crash_restart,0.00,0,1,6,5,2024,2109,85
leader_crash_restart,0.00,0,1,1,1,307,402,95
leader_crash_restart,0.00,0,1,2,1,971,1003,32
leader_crash_restart,0.00,0,1,3,9,402,502,100
leader_crash_restart,0.00,0,1,4,9,2608,2610,2
leader_crash_restart,0.00,0,1,5,9,3118,3212,94
leader_crash_restart,0.00,0,1,6,15,301,402,101
leader_crash_restart,0.00,0,1,7,15,504,602,98
leader_crash_restart,0.00,0,1,8,15,1183,1204,21
leader_crash_restart,0.00,0,1,9,35,3021,3114,93
leader_crash_restart,0.00,0,1,10,35,5240,5322,82
leader_crash_restart,0.00,0,1,11,35,5847,5925,78
leader_crash_restart,0.00,0,1,12,42,402,502,100
leader_crash_restart,0.00,0,1,13,42,604,703,99
leader_crash_restart,0.00,0,1,14,42,1299,1305,6
leader_crash_restart,0.00,0,1,15,49,402,501,99
leader_crash_restart,0.00,0,1,16,49,605,701,96
leader_crash_restart,0.00,0,1,1,1,406,501,95
leader_crash_restart,0.00,0,1,2,1,1119,1205,86
leader_crash_restart,0.00,0,1,3,3,503,602,99
leader_crash_restart,0.00,0,1,4,3,708,802,94
leader_crash_restart,0.00,0,1,1,1,304,401,97
leader_crash_restart,0.00,0,1,12,57,596,602,6
leader_crash_restart,0.00,0,1,13,65,3020,3118,98
leader_crash_restart,0.00,0,1,22,104,303,403,100
leader_crash_restart,0.00,0,1,2,1,353,403,50
leader_crash_restart,0.00,0,1,1,1,353,403,50
leader_crash_restart,0.00,0,1,4,1,353,403,50
leader_crash_restart,0.00,0,1,3,1,353,403,50
leader_crash_restart,0.00,0,1,5,1,353,403,50
leader_crash_restart,0.00,0,1,7,1,415,504,89
leader_crash_restart,0.00,0,1,6,1,415,505,90
leader_crash_restart,0.00,0,1,9,1,415,505,90
leader_crash_restart,0.00,0,1,8,1,415,505,90
leader_crash_restart,0.00,0,1,10,1,415,505,90
leader_crash_restart,0.00,0,1,12,1,517,615,98
leader_crash_restart,0.00,0,1,11,1,517,615,98
leader_crash_restart,0.00,0,1,14,1,517,615,98
leader_crash_restart,0.00,0,1,13,1,517,615,98
leader_crash_restart,0.00,0,1,15,1,517,615,98
leader_crash_restart,0.00,0,1,17,1,619,716,97
leader_crash_restart,0.00,0,1,16,1,619,716,97
leader_crash_restart,0.00,0,1,19,1,619,716,97
leader_crash_restart,0.00,0,1,20,1,619,716,97
leader_crash_restart,0.00,0,1,18,1,619,716,97
leader_crash_restart,0.00,0,1,22,1,721,813,92
leader_crash_restart,0.00,0,1,21,1,721,813,92
leader_crash_restart,0.00,0,1,24,1,721,813,92
leader_crash_restart,0.00,0,1,23,1,721,813,92
leader_crash_restart,0.00,0,1,25,1,721,813,92
leader_crash_restart,0.00,0,1,27,1,822,911,89
leader_crash_restart,0.00,0,1,26,1,822,911,89
leader_crash_restart,0.00,0,1,29,1,822,911,89
leader_crash_restart,0.00,0,1,28,1,822,911,89
leader_crash_restart,0.00,0,1,30,1,822,911,89
leader_crash_restart,0.00,0,1,32,1,925,1014,89
leader_crash_restart,0.00,0,1,31,1,925,1014,89
leader_crash_restart,0.00,0,1,34,1,925,1014,89
leader_crash_restart,0.00,0,1,33,1,925,1014,89
leader_crash_restart,0.00,0,1,35,1,925,1014,89
leader_crash_restart,0.00,0,1,37,1,1027,1120,93
leader_crash_restart,0.00,0,1,36,1,1027,1120,93
leader_crash_restart,0.00,0,1,39,1,1027,1120,93
leader_crash_restart,0.00,0,1,38,1,1027,1120,93
leader_crash_restart,0.00,0,1,40,1,1027,1120,93
leader_crash_restart,0.00,0,1,42,1,1129,1215,86
leader_crash_restart,0.00,0,1,41,1,1129,1215,86
leader_crash_restart,0.00,0,1,44,1,1129,1215,86
leader_crash_restart,0.00,0,1,43,1,1129,1215,86
leader_crash_restart,0.00,0,1,45,1,1129,1215,86
leader_crash_restart,0.00,0,1,46,1,1231,1321,90
leader_crash_restart,0.00,0,1,47,1,1231,1321,90
leader_crash_restart,0.00,0,1,49,1,1231,1321,90
leader_crash_restart,0.00,0,1,48,1,1231,1321,90
leader_crash_restart,0.00,0,1,50,1,1231,1321,90
leader_crash_restart,0.00,0,1,52,1,1333,1419,86
leader_crash_restart,0.00,0,1,51,1,1333,1420,87
leader_crash_restart,0.00,0,1,54,1,1333,1420,87
leader_crash_restart,0.00,0,1,53,1,1333,1420,87
leader_crash_restart,0.00,0,1,55,1,1333,1420,87
leader_crash_restart,0.00,0,1,57,1,1434,1525,91
leader_crash_restart,0.00,0,1,56,1,1434,1525,91
leader_crash_restart,0.00,0,1,59,1,1434,1525,91
leader_crash_restart,0.00,0,1,58,1,1434,1525,91
leader_crash_restart,0.00,0,1,60,1,1434,1525,91
leader_crash_restart,0.00,0,1,62,1,1537,1621,84
leader_crash_restart,0.00,0,1,61,1,1536,1622,86
leader_crash_restart,0.00,0,1,64,1,1537,1622,85
leader_crash_restart,0.00,0,1,63,1,1537,1622,85
leader_crash_restart,0.00,0,1,65,1,1537,1622,85
leader_crash_restart,0.00,0,1,66,1,1639,1717,78
leader_crash_restart,0.00,0,1,67,1,1639,1718,79
leader_crash_restart,0.00,0,1,69,1,1639,1718,79
leader_crash_restart,0.00,0,1,68,1,1639,1718,79
leader_crash_restart,0.00,0,1,70,1,1639,1718,79
leader_crash_restart,0.00,0,1,72,1,1720,1816,96
leader_crash_restart,0.00,0,1,71,1,1720,1816,96
leader_crash_restart,0.00,0,1,73,1,1720,1816,96
leader_crash_restart,0.00,0,1,74,1,1720,1816,96
leader_crash_restart,0.00,0,1,75,1,1720,1816,96
leader_crash_restart,0.00,0,1,77,1,1822,1919,97
leader_crash_restart,0.00,0,1,76,1,1822,1919,97
leader_crash_restart,0.00,0,1,79,1,1822,1919,97
leader_crash_restart,0.00,0,1,78,1,1822,1919,97
leader_crash_restart,0.00,0,1,80,1,1822,1919,97
leader_crash_restart,0.00,0,1,82,1,1924,2008,84
leader_crash_restart,0.00,0,1,81,1,1924,2008,84
leader_crash_restart,0.00,0,1,84,1,1924,2008,84
leader_crash_restart,0.00,0,1,83,1,1924,2008,84
leader_crash_restart,0.00,0,1,85,1,1924,2008,84
leader_crash_restart,0.00,0,1,87,1,2026,2108,82
leader_crash_restart,0.00,0,1,90,1,2026,2108,82
leader_crash_restart,0.00,0,1,86,1,2026,2108,82
leader_crash_restart,0.00,0,1,89,1,2026,2108,82
leader_crash_restart,0.00,0,1,88,1,2026,2108,82
leader_crash_restart,0.00,0,1,92,1,2127,2212,85
leader_crash_restart,0.00,0,1,91,1,2127,2213,86
leader_crash_restart,0.00,0,1,94,1,2127,2213,86
leader_crash_restart,0.00,0,1,95,1,2127,2213,86
leader_crash_restart,0.00,0,1,93,1,2127,2213,86
leader_crash_restart,0.00,0,1,97,1,2228,2321,93
leader_crash_restart,0.00,0,1,96,1,2228,2321,93
leader_crash_restart,0.00,0,1,99,1,2228,2321,93
leader_crash_restart,0.00,0,1,98,1,2228,2321,93
leader_crash_restart,0.00,0,1,100,1,2228,2321,93
leader_crash_restart,0.00,0,1,102,1,2330,2421,91
leader_crash_restart,0.00,0,1,101,1,2330,2421,91
leader_crash_restart,0.00,0,1,104,1,2331,2421,90
leader_crash_restart,0.00,0,1,103,1,2330,2421,91
leader_crash_restart,0.00,0,1,105,1,2331,2421,90
leader_crash_restart,0.00,0,1,107,1,2433,2523,90
leader_crash_restart,0.00,0,1,106,1,2433,2523,90
leader_crash_restart,0.00,0,1,109,1,2433,2523,90
leader_crash_restart,0.00,0,1,108,1,2433,2523,90
leader_crash_restart,0.00,0,1,110,1,2433,2523,90
leader_crash_restart,0.00,0,1,112,1,2534,2622,88
leader_crash_restart,0.00,0,1,111,1,2534,2623,89
leader_crash_restart,0.00,0,1,114,1,2535,2623,88
leader_crash_restart,0.00,0,1,113,1,2534,2623,89
leader_crash_restart,0.00,0,1,115,1,2535,2623,88
leader_crash_restart,0.00,0,1,117,1,2636,2719,83
leader_crash_restart,0.00,0,1,116,1,2636,2720,84
leader_crash_restart,0.00,0,1,119,1,2636,2720,84
leader_crash_restart,0.00,0,1,118,1,2636,2720,84
leader_crash_restart,0.00,0,1,120,1,2637,2720,83
leader_crash_restart,0.00,0,1,121,1,2738,2822,84
leader_crash_restart,0.00,0,1,122,1,2738,2822,84
leader_crash_restart,0.00,0,1,124,1,2738,2822,84
leader_crash_restart,0.00,0,1,123,1,2738,2822,84
leader_crash_restart,0.00,0,1,125,1,2738,2822,84
leader_crash_restart,0.00,0,1,127,1,2840,2911,71
leader_crash_restart,0.00,0,1,126,1,2840,2911,71
leader_crash_restart,0.00,0,1,129,1,2840,2911,71
leader_crash_restart,0.00,0,1,128,1,2840,2911,71
leader_crash_restart,0.00,0,1,130,1,2840,2911,71
leader_crash_restart,0.00,0,1,132,1,2921,3022,101
leader_crash_restart,0.00,0,1,131,1,2921,3022,101
leader_crash_restart,0.00,0,1,134,1,2921,3022,101
leader_crash_restart,0.00,0,1,133,1,2921,3022,101
leader_crash_restart,0.00,0,1,135,1,2921,3022,101
leader_crash_restart,0.00,0,1,137,1,3023,3124,101
leader_crash_restart,0.00,0,1,136,1,3023,3124,101
leader_crash_restart,0.00,0,1,139,1,3023,3124,101
leader_crash_restart,0.00,0,1,138,1,3023,3124,101
leader_crash_restart,0.00,0,1,140,1,3023,3124,101
leader_crash_restart,0.00,0,1,142,1,3125,3215,90
leader_crash_restart,0.00,0,1,141,1,3125,3215,90
leader_crash_restart,0.00,0,1,144,1,3125,3215,90
leader_crash_restart,0.00,0,1,143,1,3125,3215,90
leader_crash_restart,0.00,0,1,145,1,3125,3215,90
leader_crash_restart,0.00,0,1,147,1,3227,3322,95
leader_crash_restart,0.00,0,1,150,1,3227,3323,96
leader_crash_restart,0.00,0,1,146,1,3227,3323,96
leader_crash_restart,0.00,0,1,149,1,3227,3323,96
leader_crash_restart,0.00,0,1,148,1,3227,3323,96
leader_crash_restart,0.00,0,1,152,1,3328,3419,91
leader_crash_restart,0.00,0,1,151,1,3328,3419,91
leader_crash_restart,0.00,0,1,154,1,3329,3419,90
leader_crash_restart,0.00,0,1,153,1,3328,3419,91
leader_crash_restart,0.00,0,1,155,1,3329,3419,90
leader_crash_restart,0.00,0,1,157,1,3430,3522,92
leader_crash_restart,0.00,0,1,160,1,3431,3522,91
leader_crash_restart,0.00,0,1,156,1,3430,3522,92
leader_crash_restart,0.00,0,1,159,1,3431,3522,91
leader_crash_restart,0.00,0,1,158,1,3430,3522,92
leader_crash_restart,0.00,0,1,162,1,3532,3623,91
leader_crash_restart,0.00,0,1,161,1,3532,3624,92
leader_crash_restart,0.00,0,1,164,1,3533,3624,91
leader_crash_restart,0.00,0,1,163,1,3532,3624,92
leader_crash_restart,0.00,0,1,165,1,3533,3624,91
leader_crash_restart,0.00,0,1,167,1,3634,3732,98
leader_crash_restart,0.00,0,1,166,1,3634,3732,98
leader_crash_restart,0.00,0,1,169,1,3635,3732,97
leader_crash_restart,0.00,0,1,170,1,3635,3732,97
leader_crash_restart,0.00,0,1,168,1,3635,3732,97
leader_crash_restart,0.00,0,1,172,1,3736,3824,88
leader_crash_restart,0.00,0,1,171,1,3736,3824,88
leader_crash_restart,0.00,0,1,174,1,3736,3824,88
leader_crash_restart,0.00,0,1,173,1,3736,3824,88
leader_crash_restart,0.00,0,1,175,1,3736,3824,88
leader_crash_restart,0.00,0,1,177,1,3837,3927,90
leader_crash_restart,0.00,0,1,176,1,3837,3927,90
leader_crash_restart,0.00,0,1,179,1,3837,3927,90
leader_crash_restart,0.00,0,1,178,1,3837,3927,90
leader_crash_restart,0.00,0,1,180,1,3838,3927,89
leader_crash_restart,0.00,0,1,182,1,3940,4018,78
leader_crash_restart,0.00,0,1,181,1,3940,4019,79
leader_crash_restart,0.00,0,1,183,1,3940,4019,79
leader_crash_restart,0.00,0,1,184,1,3940,4019,79
leader_crash_restart,0.00,0,1,185,1,3940,4019,79
leader_crash_restart,0.00,0,1,187,1,4021,4035,14
leader_crash_restart,0.00,0,1,186,1,4021,4035,14
leader_crash_restart,0.00,0,1,189,1,4021,4035,14
leader_crash_restart,0.00,0,1,188,1,4021,4035,14
leader_crash_restart,0.00,0,1,190,1,4021,4035,14
leader_crash_restart,0.00,0,1,192,1,4041,4123,82
leader_crash_restart,0.00,0,1,191,1,4041,4124,83
leader_crash_restart,0.00,0,1,194,1,4041,4124,83
leader_crash_restart,0.00,0,1,193,1,4041,4124,83
leader_crash_restart,0.00,0,1,195,1,4041,4124,83
leader_crash_restart,0.00,0,1,197,1,4143,4227,84
leader_crash_restart,0.00,0,1,196,1,4143,4227,84
leader_crash_restart,0.00,0,1,199,1,4143,4227,84
leader_crash_restart,0.00,0,1,198,1,4143,4227,84
leader_crash_restart,0.00,0,1,200,1,4143,4227,84
leader_crash_restart,0.00,0,1,202,1,4244,4316,72
leader_crash_restart,0.00,0,1,201,1,4244,4317,73
leader_crash_restart,0.00,0,1,204,1,4245,4317,72
leader_crash_restart,0.00,0,1,203,1,4244,4317,73
leader_crash_restart,0.00,0,1,205,1,4245,4317,72
leader_crash_restart,0.00,0,1,207,1,4325,4338,13
leader_crash_restart,0.00,0,1,206,1,4325,4338,13
leader_crash_restart,0.00,0,1,209,1,4326,4338,12
leader_crash_restart,0.00,0,1,208,1,4325,4338,13
leader_crash_restart,0.00,0,1,210,1,4326,4338,12
leader_crash_restart,0.00,0,1,212,1,4346,4421,75
leader_crash_restart,0.00,0,1,211,1,4346,4421,75
leader_crash_restart,0.00,0,1,214,1,4346,4421,75
leader_crash_restart,0.00,0,1,213,1,4346,4421,75
leader_crash_restart,0.00,0,1,215,1,4346,4421,75
leader_crash_restart,0.00,0,1,217,1,4427,4533,106
leader_crash_restart,0.00,0,1,216,1,4427,4533,106
leader_crash_restart,0.00,0,1,219,1,4429,4533,104
leader_crash_restart,0.00,0,1,218,1,4428,4533,105
leader_crash_restart,0.00,0,1,220,1,4429,4533,104
leader_crash_restart,0.00,0,1,221,1,4549,4620,71
leader_crash_restart,0.00,0,1,222,1,4549,4621,72
leader_crash_restart,0.00,0,1,224,1,4549,4621,72
leader_crash_restart,0.00,0,1,223,1,4549,4621,72
leader_crash_restart,0.00,0,1,225,1,4549,4621,72
leader_crash_restart,0.00,0,1,227,1,4630,4729,99
leader_crash_restart,0.00,0,1,226,1,4630,4729,99
leader_crash_restart,0.00,0,1,229,1,4631,4729,98
leader_crash_restart,0.00,0,1,228,1,4630,4729,99
leader_crash_restart,0.00,0,1,230,1,4631,4729,98
leader_crash_restart,0.00,0,1,232,1,4731,4832,101
leader_crash_restart,0.00,0,1,231,1,4731,4832,101
leader_crash_restart,0.00,0,1,234,1,4732,4832,100
leader_crash_restart,0.00,0,1,233,1,4731,4833,102
leader_crash_restart,0.00,0,1,235,1,4732,4833,101
leader_crash_restart,0.00,0,1,237,1,4834,4921,87
leader_crash_restart,0.00,0,1,236,1,4834,4921,87
leader_crash_restart,0.00,0,1,239,1,4834,4921,87
leader_crash_restart,0.00,0,1,238,1,4834,4921,87
leader_crash_restart,0.00,0,1,240,1,4834,4921,87
leader_crash_restart,0.00,0,1,242,1,4936,5028,92
leader_crash_restart,0.00,0,1,241,1,4936,5029,93
leader_crash_restart,0.00,0,1,244,1,4936,5029,93
leader_crash_restart,0.00,0,1,245,1,4936,5029,93
leader_crash_restart,0.00,0,1,243,1,4936,5029,93
leader_crash_restart,0.00,0,1,246,1,5038,5116,78
leader_crash_restart,0.00,0,1,1,1,354,406,52
leader_crash_restart,0.00,0,1,2,1,340,401,61
leader_crash_restart,0.00,0,1,1,1,318,401,83
leader_crash_restart,0.00,0,1,3,1,386,401,15
leader_crash_restart,0.00,0,1,5,1,422,501,79
leader_crash_restart,0.00,0,1,4,1,417,501,84
leader_crash_restart,0.00,0,1,6,1,499,501,2
leader_crash_restart,0.00,0,1,8,1,510,602,92
leader_crash_restart,0.00,0,1,7,1,502,602,100
leader_crash_restart,0.00,0,1,9,1,598,602,4
leader_crash_restart,0.00,0,1,11,1,684,701,17
leader_crash_restart,0.00,0,1,10,1,609,701,92
leader_crash_restart,0.00,0,1,12,1,691,701,10
leader_crash_restart,0.00,0,1,13,1,716,802,86
leader_crash_restart,0.00,0,1,14,1,722,802,80
leader_crash_restart,0.00,0,1,15,1,790,802,12
leader_crash_restart,0.00,0,1,16,1,803,803,0
leader_crash_restart,0.00,0,1,18,1,821,902,81
leader_crash_restart,0.00,0,1,17,1,814,902,88
leader_crash_restart,0.00,0,1,19,1,898,902,4
leader_crash_restart,0.00,0,1,21,1,996,1002,6
leader_crash_restart,0.00,0,1,20,1,908,1002,94
leader_crash_restart,0.00,0,1,22,1,1002,1004,2
leader_crash_restart,0.00,0,1,24,1,1014,1103,89
leader_crash_restart,0.00,0,1,23,1,1006,1103,97
leader_crash_restart,0.00,0,1,25,1,1091,1103,12
leader_crash_restart,0.00,0,1,27,1,1198,1203,5
leader_crash_restart,0.00,0,1,26,1,1122,1203,81
leader_crash_restart,0.00,0,1,28,1,1200,1203,3
leader_crash_restart,0.00,0,1,30,1,1210,1303,93
leader_crash_restart,0.00,0,1,29,1,1208,1304,96
leader_crash_restart,0.00,0,1,31,1,1303,1304,1
leader_crash_restart,0.00,0,1,33,1,1390,1403,13
leader_crash_restart,0.00,0,1,32,1,1313,1404,91
leader_crash_restart,0.00,0,1,34,1,1392,1404,12
leader_crash_restart,0.00,0,1,36,1,1423,1505,82
leader_crash_restart,0.00,0,1,35,1,1421,1505,84
leader_crash_restart,0.00,0,1,37,1,1495,1505,10
leader_crash_restart,0.00,0,1,38,1,1505,1508,3
leader_crash_restart,0.00,0,1,40,1,1604,1607,3
leader_crash_restart,0.00,0,1,39,1,1519,1607,88
leader_crash_restart,0.00,0,1,41,1,1605,1607,2
leader_crash_restart,0.00,0,1,43,1,1617,1706,89
leader_crash_restart,0.00,0,1,42,1,1617,1706,89
leader_crash_restart,0.00,0,1,44,1,1700,1706,6
leader_crash_restart,0.00,0,1,46,1,1798,1806,8
leader_crash_restart,0.00,0,1,45,1,1711,1807,96
leader_crash_restart,0.00,0,1,47,1,1798,1807,9
leader_crash_restart,0.00,0,1,49,1,1808,1907,99
leader_crash_restart,0.00,0,1,48,1,1808,1907,99
leader_crash_restart,0.00,0,1,50,1,1892,1907,15
leader_crash_restart,0.00,0,1,52,1,1990,2007,17
leader_crash_restart,0.00,0,1,51,1,1923,2008,85
leader_crash_restart,0.00,0,1,53,1,1990,2008,18
leader_crash_restart,0.00,0,1,55,1,2020,2107,87
leader_crash_restart,0.00,0,1,54,1,2020,2108,88
leader_crash_restart,0.00,0,1,56,1,2104,2108,4
leader_crash_restart,0.00,0,1,58,1,2202,2208,6
leader_crash_restart,0.00,0,1,57,1,2115,2209,94
leader_crash_restart,0.00,0,1,59,1,2202,2209,7
leader_crash_restart,0.00,0,1,61,1,2212,2309,97
leader_crash_restart,0.00,0,1,60,1,2212,2309,97
leader_crash_restart,0.00,0,1,62,1,2296,2309,13
leader_crash_restart,0.00,0,1,64,1,2393,2409,16
leader_crash_restart,0.00,0,1,63,1,2326,2409,83
leader_crash_restart,0.00,0,1,65,1,2393,2409,16
leader_crash_restart,0.00,0,1,67,1,2424,2510,86
leader_crash_restart,0.00,0,1,66,1,2424,2510,86
leader_crash_restart,0.00,0,1,68,1,2507,2510,3
leader_crash_restart,0.00,0,1,70,1,2605,2609,4
leader_crash_restart,0.00,0,1,69,1,2518,2610,92
leader_crash_restart,0.00,0,1,71,1,2605,2610,5
leader_crash_restart,0.00,0,1,73,1,2615,2710,95
leader_crash_restart,0.00,0,1,72,1,2615,2711,96
leader_crash_restart,0.00,0,1,74,1,2699,2711,12
leader_crash_restart,0.00,0,1,76,1,2796,2810,14
leader_crash_restart,0.00,0,1,75,1,2730,2810,80
leader_crash_restart,0.00,0,1,77,1,2796,2810,14
leader_crash_restart,0.00,0,1,78,1,2811,2814,3
leader_crash_restart,0.00,0,1,80,1,2827,2910,83
leader_crash_restart,0.00,0,1,79,1,2821,2911,90
leader_crash_restart,0.00,0,1,81,1,2827,2911,84
leader_crash_restart,0.00,0,1,83,1,3009,3011,2
leader_crash_restart,0.00,0,1,82,1,3003,3011,8
leader_crash_restart,0.00,0,1,84,1,3009,3011,2
leader_crash_restart,0.00,0,1,85,1,3014,3014,0
leader_crash_restart,0.00,0,1,87,1,3019,3111,92
leader_crash_restart,0.00,0,1,86,1,3019,3112,93
leader_crash_restart,0.00,0,1,88,1,3025,3112,87
leader_crash_restart,0.00,0,1,90,1,3200,3211,11
leader_crash_restart,0.00,0,1,89,1,3200,3212,12
leader_crash_restart,0.00,0,1,91,1,3207,3212,5
leader_crash_restart,0.00,0,1,93,1,3231,3314,83
leader_crash_restart,0.00,0,1,92,1,3217,3314,97
leader_crash_restart,0.00,0,1,94,1,3231,3314,83
leader_crash_restart,0.00,0,1,95,1,3399,3413,14
leader_crash_restart,0.00,0,1,97,1,3413,3417,4
leader_crash_restart,0.00,0,1,96,1,3413,3417,4
leader_crash_restart,0.00,0,1,99,1,3423,3513,90
leader_crash_restart,0.00,0,1,98,1,3423,3513,90
leader_crash_restart,0.00,0,1,100,1,3429,3513,84
leader_crash_restart,0.00,0,1,102,1,3604,3613,9
leader_crash_restart,0.00,0,1,101,1,3604,3613,9
leader_crash_restart,0.00,0,1,103,1,3610,3613,3
leader_crash_restart,0.00,0,1,105,1,3615,3618,3
leader_crash_restart,0.00,0,1,104,1,3615,3618,3
leader_crash_restart,0.00,0,1,106,1,3621,3713,92
leader_crash_restart,0.00,0,1,107,1,3625,3714,89
leader_crash_restart,0.00,0,1,108,1,3625,3714,89
leader_crash_restart,0.00,0,1,110,1,3806,3814,8
leader_crash_restart,0.00,0,1,109,1,3802,3814,12
leader_crash_restart,0.00,0,1,111,1,3806,3814,8
leader_crash_restart,0.00,0,1,113,1,3817,3818,1
leader_crash_restart,0.00,0,1,112,1,3817,3818,1
leader_crash_restart,0.00,0,1,115,1,3827,3914,87
leader_crash_restart,0.00,0,1,114,1,3827,3914,87
leader_crash_restart,0.00,0,1,116,1,3832,3914,82
leader_crash_restart,0.00,0,1,118,1,4008,4016,8
leader_crash_restart,0.00,0,1,117,1,4008,4016,8
leader_crash_restart,0.00,0,1,119,1,4013,4016,3
leader_crash_restart,0.00,0,1,121,1,4019,4114,95
leader_crash_restart,0.00,0,1,120,1,4019,4115,96
leader_crash_restart,0.00,0,1,122,1,4024,4115,91
leader_crash_restart,0.00,0,1,124,1,4201,4214,13
leader_crash_restart,0.00,0,1,123,1,4201,4214,13
leader_crash_restart,0.00,0,1,125,1,4205,4214,9
leader_crash_restart,0.00,0,1,126,1,4216,4219,3
leader_crash_restart,0.00,0,1,128,1,4231,4315,84
leader_crash_restart,0.00,0,1,127,1,4226,4315,89
leader_crash_restart,0.00,0,1,129,1,4231,4315,84
leader_crash_restart,0.00,0,1,131,1,4412,4415,3
leader_crash_restart,0.00,0,1,130,1,4407,4416,9
leader_crash_restart,0.00,0,1,132,1,4412,4416,4
leader_crash_restart,0.00,0,1,133,1,4418,4419,1
leader_crash_restart,0.00,0,1,135,1,4423,4515,92
leader_crash_restart,0.00,0,1,134,1,4423,4516,93
leader_crash_restart,0.00,0,1,136,1,4428,4516,88
leader_crash_restart,0.00,0,1,138,1,4604,4616,12
leader_crash_restart,0.00,0,1,137,1,4604,4616,12
leader_crash_restart,0.00,0,1,139,1,4609,4616,7
leader_crash_restart,0.00,0,1,140,1,4619,4619,0
leader_crash_restart,0.00,0,1,142,1,4634,4716,82
leader_crash_restart,0.00,0,1,141,1,4630,4717,87
leader_crash_restart,0.00,0,1,143,1,4634,4717,83
leader_crash_restart,0.00,0,1,144,1,4811,4817,6
leader_crash_restart,0.00,0,1,146,1,4817,4820,3
leader_crash_restart,0.00,0,1,145,1,4816,4820,4
leader_crash_restart,0.00,0,1,148,1,4827,8446,3619
leader_crash_restart,0.00,0,1,147,1,4821,8446,3625
leader_crash_restart,0.00,0,1,150,1,5203,8446,3243
leader_crash_restart,0.00,0,1,149,1,4827,8446,3619
leader_crash_restart,0.00,0,1,152,1,5209,8446,3237
leader_crash_restart,0.00,0,1,174,1,8263,8446,183
leader_crash_restart,0.00,0,1,151,1,5208,8446,3238
leader_crash_restart,0.00,0,1,154,1,5589,8446,2857
leader_crash_restart,0.00,0,1,153,1,5585,8446,2861
leader_crash_restart,0.00,0,1,156,1,5967,8446,2479
leader_crash_restart,0.00,0,1,155,1,5590,8446,2856
leader_crash_restart,0.00,0,1,158,1,5973,8446,2473
leader_crash_restart,0.00,0,1,157,1,5971,8446,2475
leader_crash_restart,0.00,0,1,160,1,6353,8446,2093
leader_crash_restart,0.00,0,1,159,1,6349,8446,2097
leader_crash_restart,0.00,0,1,162,1,6736,8446,1710
leader_crash_restart,0.00,0,1,161,1,6355,8446,2091
leader_crash_restart,0.00,0,1,164,1,6742,8446,1704
leader_crash_restart,0.00,0,1,163,1,6741,8446,1705
leader_crash_restart,0.00,0,1,166,1,7123,8446,1323
leader_crash_restart,0.00,0,1,165,1,7118,8446,1328
leader_crash_restart,0.00,0,1,168,1,7500,8446,946
leader_crash_restart,0.00,0,1,167,1,7124,8446,1322
leader_crash_restart,0.00,0,1,170,1,7505,8446,941
leader_crash_restart,0.00,0,1,169,1,7505,8446,941
leader_crash_restart,0.00,0,1,172,1,7888,8446,558
leader_crash_restart,0.00,0,1,171,1,7882,8446,564
leader_crash_restart,0.00,0,1,173,1,7888,8446,558
leader_crash_restart,0.00,0,1,176,1,8269,8446,177
leader_crash_restart,0.00,0,1,175,1,8269,8446,177
leader_crash_restart,0.00,0,1,178,1,8450,8532,82
leader_crash_restart,0.00,0,1,177,1,8450,8532,82
leader_crash_restart,0.00,0,1,180,1,8631,8632,1
leader_crash_restart,0.00,0,1,179,1,8631,8633,2
leader_crash_restart,0.00,0,1,182,1,8642,8733,91
leader_crash_restart,0.00,0,1,181,1,8642,8734,92
leader_crash_restart,0.00,0,1,183,1,8645,8734,89
leader_crash_restart,0.00,0,1,185,1,8823,8834,11
leader_crash_restart,0.00,0,1,184,1,8823,8834,11
leader_crash_restart,0.00,0,1,186,1,8826,8834,8
leader_crash_restart,0.00,0,1,187,1,8836,8840,4
leader_crash_restart,0.00,0,1,189,1,8854,8934,80
leader_crash_restart,0.00,0,1,188,1,8846,8934,88
leader_crash_restart,0.00,0,1,190,1,8854,8934,80
leader_crash_restart,0.00,0,1,192,1,8935,8940,5
leader_crash_restart,0.00,0,1,191,1,8935,8941,6
leader_crash_restart,0.00,0,1,194,1,8945,9036,91
leader_crash_restart,0.00,0,1,193,1,8945,9036,91
leader_crash_restart,0.00,0,1,195,1,9028,9036,8
leader_crash_restart,0.00,0,1,196,1,9038,9041,3
leader_crash_restart,0.00,0,1,198,1,9126,9134,8
leader_crash_restart,0.00,0,1,197,1,9049,9135,86
leader_crash_restart,0.00,0,1,199,1,9126,9135,9
leader_crash_restart,0.00,0,1,201,1,9137,9141,4
leader_crash_restart,0.00,0,1,200,1,9137,9141,4
leader_crash_restart,0.00,0,1,202,1,9147,9236,89
leader_crash_restart,0.00,0,1,203,1,9147,9236,89
leader_crash_restart,0.00,0,1,204,1,9230,9236,6
leader_crash_restart,0.00,0,1,205,1,9241,9241,0
leader_crash_restart,0.00,0,1,207,1,9328,9335,7
leader_crash_restart,0.00,0,1,206,1,9251,9336,85
leader_crash_restart,0.00,0,1,208,1,9328,9336,8
leader_crash_restart,0.00,0,1,210,1,9339,9342,3
leader_crash_restart,0.00,0,1,209,1,9339,9343,4
leader_crash_restart,0.00,0,1,212,1,9350,9435,85
leader_crash_restart,0.00,0,1,211,1,9350,9436,86
leader_crash_restart,0.00,0,1,213,1,9433,9436,3
leader_crash_restart,0.00,0,1,215,1,9533,9535,2
leader_crash_restart,0.00,0,1,214,1,9443,9536,93
leader_crash_restart,0.00,0,1,216,1,9533,9536,3
leader_crash_restart,0.00,0,1,217,1,9543,9543,0
leader_crash_restart,0.00,0,1,219,1,9554,9637,83
leader_crash_restart,0.00,0,1,218,1,9543,9637,94
leader_crash_restart,0.00,0,1,220,1,9625,9637,12
leader_crash_restart,0.00,0,1,222,1,9724,9736,12
leader_crash_restart,0.00,0,1,221,1,9656,9736,80
leader_crash_restart,0.00,0,1,223,1,9735,9736,1
leader_crash_restart,0.00,0,1,224,1,9738,9744,6
leader_crash_restart,0.00,0,1,226,1,9748,9837,89
leader_crash_restart,0.00,0,1,225,1,9745,9838,93
leader_crash_restart,0.00,0,1,227,1,9754,9838,84
leader_crash_restart,0.00,0,1,229,1,9929,9938,9
leader_crash_restart,0.00,0,1,228,1,9927,9938,11
leader_crash_restart,0.00,0,1,230,1,9936,9938,2
leader_crash_restart,0.00,0,1,231,1,9940,9944,4
leader_crash_restart,0.00,0,1,233,1,9950,10038,88
leader_crash_restart,0.00,0,1,232,1,9947,10039,92
leader_crash_restart,0.00,0,1,234,1,9958,10039,81
leader_crash_restart,0.00,0,1,235,1,10040,10045,5
leader_crash_restart,0.00,0,1,237,1,10128,10141,13
leader_crash_restart,0.00,0,1,236,1,10050,10141,91
leader_crash_restart,0.00,0,1,238,1,10131,10141,10
leader_crash_restart,0.00,0,1,239,1,10142,10145,3
leader_crash_restart,0.00,0,1,241,1,10159,10238,79
leader_crash_restart,0.00,0,1,240,1,10152,10239,87
leader_crash_restart,0.00,0,1,242,1,10232,10239,7
leader_crash_restart,0.00,0,1,244,1,10243,10246,3
leader_crash_restart,0.00,0,1,243,1,10240,10246,6
leader_crash_restart,0.00,0,1,246,1,10253,10339,86
leader_crash_restart,0.00,0,1,245,1,10251,10339,88
leader_crash_restart,0.00,0,1,247,1,10334,10339,5
leader_crash_restart,0.00,0,1,248,1,10344,10346,2
leader_crash_restart,0.00,0,1,250,1,10432,10439,7
leader_crash_restart,0.00,0,1,249,1,10355,10440,85
leader_crash_restart,0.00,0,1,251,1,10434,10440,6
leader_crash_restart,0.00,0,1,253,1,10444,10446,2
leader_crash_restart,0.00,0,1,252,1,10442,10447,5
leader_crash_restart,0.00,0,1,1,1,303,402,99
leader_crash_restart,0.00,0,1,2,2,405,503,98
leader_crash_restart,0.00,0,1,3,3,1452,1505,53
leader_crash_restart,0.00,0,1,4,4,1415,1505,90
leader_crash_restart,0.00,0,1,5,4,2262,2308,46
leader_crash_restart,0.00,0,1,6,4,2427,2508,81
leader_crash_restart,0.00,0,1,1,1,408,503,95
leader_crash_restart,0.00,0,1,2,1,1117,1205,88
leader_crash_restart,0.00,0,1,3,8,404,502,98
leader_crash_restart,0.00,0,1,4,8,2524,2609,85
leader_crash_restart,0.00,0,1,5,8,3158,3211,53
leader_crash_restart,0.00,0,1,6,15,503,602,99
leader_crash_restart,0.00,0,1,7,15,706,802,96
leader_crash_restart,0.00,0,1,8,15,1455,1506,51
leader_crash_restart,0.00,0,1,9,24,806,904,98
leader_crash_restart,0.00,0,1,10,24,3031,3111,80
leader_crash_restart,0.00,0,1,11,24,3679,3714,35
leader_crash_restart,0.00,0,1,12,30,351,401,50
leader_crash_restart,0.00,0,1,13,30,513,602,89
leader_crash_restart,0.00,0,1,14,30,1141,1204,63
leader_crash_restart,0.00,0,1,15,37,402,502,100
leader_crash_restart,0.00,0,1,16,37,606,703,97
leader_crash_restart,0.00,0,1,1,2,707,806,99
leader_crash_restart,0.00,0,1,2,2,1396,1409,13
leader_crash_restart,0.00,0,1,3,4,302,401,99
leader_crash_restart,0.00,0,1,4,4,509,602,93
leader_crash_restart,0.00,0,1,1,1,407,502,95
leader_crash_restart,0.00,0,1,3,9,3308,3313,5
leader_crash_restart,0.00,0,1,7,29,896,902,6
leader_crash_restart,0.00,0,1,9,33,895,903,8
leader_crash_restart,0.00,0,1,11,38,544,602,58
leader_crash_restart,0.00,0,1,13,41,692,702,10
leader_crash_restart,0.00,0,1,14,42,1798,1807,9
leader_crash_restart,0.00,0,1,24,107,518,602,84
leader_crash_restart,0.00,0,1,1,1,453,503,50
leader_crash_restart,0.00,0,1,2,2,304,403,99
leader_crash_restart,0.00,0,1,3,3,1352,1420,68
leader_crash_restart,0.00,0,1,4,4,2437,2518,81
leader_crash_restart,0.00,0,1,5,4,3239,3320,81
leader_crash_restart,0.00,0,1,6,4,3423,3521,98
leader_crash_restart,0.00,0,1,1,2,525,606,81
leader_crash_restart,0.00,0,1,2,2,1237,1310,73
leader_crash_restart,0.00,0,1,3,9,302,401,99
leader_crash_restart,0.00,0,1,4,9,505,602,97
leader_crash_restart,0.00,0,1,5,9,1095,1105,10
leader_crash_restart,0.00,0,1,6,16,403,502,99
leader_crash_restart,0.00,0,1,7,16,608,703,95
leader_crash_restart,0.00,0,1,8,16,1295,1305,10
leader_crash_restart,0.00,0,1,9,22,451,503,52
leader_crash_restart,0.00,0,1,10,22,2528,2611,83
leader_crash_restart,0.00,0,1,11,22,3235,3313,78
leader_crash_restart,0.00,0,1,12,29,403,503,100
leader_crash_restart,0.00,0,1,13,29,607,702,95
leader_crash_restart,0.00,0,1,14,29,1293,1304,11
leader_crash_restart,0.00,0,1,15,35,402,502,100
leader_crash_restart,0.00,0,1,16,35,2619,2710,91
leader_crash_restart,0.00,0,1,1,1,406,503,97
leader_crash_restart,0.00,0,1,2,1,1124,1205,81
leader_crash_restart,0.00,0,1,3,3,411,502,91
leader_crash_restart,0.00,0,1,4,3,617,702,85
leader_crash_restart,0.00,0,1,1,1,409,502,93
leader_crash_restart,0.00,0,1,2,2,899,904,5
leader_crash_restart,0.00,0,1,11,46,808,1102,294
leader_crash_restart,0.00,0,1,20,75,628,703,75
leader_crash_restart,0.00,0,1,22,78,580,601,21
leader_crash_restart,0.00,0,1,23,80,920,1013,93
leader_crash_restart,0.00,0,1,24,83,1418,1506,88
leader_crash_restart,0.00,0,1,28,92,2836,2910,74
leader_crash_restart,0.00,0,1,2,1,358,413,55
leader_crash_restart,0.00,0,1,1,1,357,413,56
leader_crash_restart,0.00,0,1,4,1,358,413,55
leader_crash_restart,0.00,0,1,5,1,358,413,55
leader_crash_restart,0.00,0,1,3,1,358,413,55
leader_crash_restart,0.00,0,1,7,1,418,513,95
leader_crash_restart,0.00,0,1,6,1,418,513,95
leader_crash_restart,0.00,0,1,9,1,418,513,95
leader_crash_restart,0.00,0,1,8,1,418,513,95
leader_crash_restart,0.00,0,1,10,1,418,513,95
leader_crash_restart,0.00,0,1,12,1,521,613,92
leader_crash_restart,0.00,0,1,11,1,521,613,92
leader_crash_restart,0.00,0,1,14,1,521,613,92
leader_crash_restart,0.00,0,1,15,1,521,613,92
leader_crash_restart,0.00,0,1,13,1,521,613,92
leader_crash_restart,0.00,0,1,17,1,623,716,93
leader_crash_restart,0.00,0,1,16,1,623,716,93
leader_crash_restart,0.00,0,1,19,1,623,716,93
leader_crash_restart,0.00,0,1,18,1,623,716,93
leader_crash_restart,0.00,0,1,20,1,623,716,93
leader_crash_restart,0.00,0,1,22,1,725,808,83
leader_crash_restart,0.00,0,1,21,1,725,808,83
leader_crash_restart,0.00,0,1,24,1,725,808,83
leader_crash_restart,0.00,0,1,23,1,725,808,83
leader_crash_restart,0.00,0,1,25,1,725,808,83
leader_crash_restart,0.00,0,1,27,1,827,911,84
leader_crash_restart,0.00,0,1,26,1,827,911,84
leader_crash_restart,0.00,0,1,29,1,827,911,84
leader_crash_restart,0.00,0,1,28,1,827,911,84
leader_crash_restart,0.00,0,1,30,1,827,911,84
leader_crash_restart,0.00,0,1,32,1,929,1014,85
leader_crash_restart,0.00,0,1,31,1,929,1014,85
leader_crash_restart,0.00,0,1,34,1,929,1014,85
leader_crash_restart,0.00,0,1,33,1,929,1014,85
leader_crash_restart,0.00,0,1,35,1,929,1014,85
leader_crash_restart,0.00,0,1,37,1,1031,1115,84
leader_crash_restart,0.00,0,1,36,1,1031,1115,84
leader_crash_restart,0.00,0,1,39,1,1031,1115,84
leader_crash_restart,0.00,0,1,38,1,1031,1115,84
leader_crash_restart,0.00,0,1,40,1,1031,1115,84
leader_crash_restart,0.00,0,1,42,1,1133,1214,81
leader_crash_restart,0.00,0,1,45,1,1133,1214,81
leader_crash_restart,0.00,0,1,41,1,1133,1214,81
leader_crash_restart,0.00,0,1,44,1,1133,1214,81
leader_crash_restart,0.00,0,1,43,1,1133,1214,81
leader_crash_restart,0.00,0,1,47,1,1214,1325,111
leader_crash_restart,0.00,0,1,46,1,1214,1325,111
leader_crash_restart,0.00,0,1,49,1,1214,1325,111
leader_crash_restart,0.00,0,1,48,1,1214,1325,111
leader_crash_restart,0.00,0,1,50,1,1214,1325,111
leader_crash_restart,0.00,0,1,52,1,1336,1417,81
leader_crash_restart,0.00,0,1,51,1,1336,1417,81
leader_crash_restart,0.00,0,1,54,1,1336,1417,81
leader_crash_restart,0.00,0,1,53,1,1336,1417,81
leader_crash_restart,0.00,0,1,55,1,1336,1417,81
leader_crash_restart,0.00,0,1,57,1,1418,1528,110
leader_crash_restart,0.00,0,1,56,1,1418,1528,110
leader_crash_restart,0.00,0,1,59,1,1418,1528,110
leader_crash_restart,0.00,0,1,58,1,1418,1528,110
leader_crash_restart,0.00,0,1,60,1,1418,1528,110
leader_crash_restart,0.00,0,1,62,1,1540,1614,74
leader_crash_restart,0.00,0,1,61,1,1540,1615,75
leader_crash_restart,0.00,0,1,64,1,1540,1615,75
leader_crash_restart,0.00,0,1,63,1,1540,1615,75
leader_crash_restart,0.00,0,1,65,1,1540,1615,75
leader_crash_restart,0.00,0,1,67,1,1622,1720,98
leader_crash_restart,0.00,0,1,66,1,1622,1721,99
leader_crash_restart,0.00,0,1,69,1,1622,1721,99
leader_crash_restart,0.00,0,1,68,1,1622,1721,99
leader_crash_restart,0.00,0,1,70,1,1622,1721,99
leader_crash_restart,0.00,0,1,72,1,1724,1821,97
leader_crash_restart,0.00,0,1,71,1,1724,1821,97
leader_crash_restart,0.00,0,1,74,1,1724,1821,97
leader_crash_restart,0.00,0,1,73,1,1724,1821,97
leader_crash_restart,0.00,0,1,75,1,1724,1821,97
leader_crash_restart,0.00,0,1,77,1,1826,1918,92
leader_crash_restart,0.00,0,1,76,1,1826,1918,92
leader_crash_restart,0.00,0,1,79,1,1826,1918,92
leader_crash_restart,0.00,0,1,78,1,1826,1918,92
leader_crash_restart,0.00,0,1,80,1,1826,1918,92
leader_crash_restart,0.00,0,1,82,1,1928,2020,92
leader_crash_restart,0.00,0,1,81,1,1928,2020,92
leader_crash_restart,0.00,0,1,84,1,1928,2020,92
leader_crash_restart,0.00,0,1,83,1,1928,2021,93
leader_crash_restart,0.00,0,1,85,1,1928,2021,93
leader_crash_restart,0.00,0,1,87,1,2029,2125,96
leader_crash_restart,0.00,0,1,86,1,2029,2125,96
leader_crash_restart,0.00,0,1,89,1,2029,2125,96
leader_crash_restart,0.00,0,1,88,1,2029,2125,96
leader_crash_restart,0.00,0,1,90,1,2029,2125,96
leader_crash_restart,0.00,0,1,92,1,2131,2215,84
leader_crash_restart,0.00,0,1,91,1,2131,2216,85
leader_crash_restart,0.00,0,1,94,1,2131,2216,85
leader_crash_restart,0.00,0,1,95,1,2131,2216,85
leader_crash_restart,0.00,0,1,93,1,2131,2216,85
leader_crash_restart,0.00,0,1,97,1,2233,2315,82
leader_crash_restart,0.00,0,1,96,1,2233,2315,82
leader_crash_restart,0.00,0,1,99,1,2233,2315,82
leader_crash_restart,0.00,0,1,98,1,2233,2315,82
leader_crash_restart,0.00,0,1,100,1,2233,2315,82
leader_crash_restart,0.00,0,1,101,1,2335,2412,77
leader_crash_restart,0.00,0,1,102,1,2335,2412,77
leader_crash_restart,0.00,0,1,104,1,2335,2412,77
leader_crash_restart,0.00,0,1,105,1,2335,2413,78
leader_crash_restart,0.00,0,1,103,1,2335,2413,78
leader_crash_restart,0.00,0,1,107,1,2416,2425,9
leader_crash_restart,0.00,0,1,106,1,2416,2425,9
leader_crash_restart,0.00,0,1,109,1,2416,2425,9
leader_crash_restart,0.00,0,1,108,1,2416,2425,9
leader_crash_restart,0.00,0,1,110,1,2416,2425,9
leader_crash_restart,0.00,0,1,112,1,2436,2521,85
leader_crash_restart,0.00,0,1,111,1,2436,2521,85
leader_crash_restart,0.00,0,1,114,1,2437,2521,84
leader_crash_restart,0.00,0,1,113,1,2436,2521,85
leader_crash_restart,0.00,0,1,115,1,2437,2521,84
leader_crash_restart,0.00,0,1,117,1,2538,2619,81
leader_crash_restart,0.00,0,1,116,1,2538,2619,81
leader_crash_restart,0.00,0,1,119,1,2538,2619,81
leader_crash_restart,0.00,0,1,118,1,2538,2619,81
leader_crash_restart,0.00,0,1,120,1,2538,2619,81
leader_crash_restart,0.00,0,1,122,1,2620,2720,100
leader_crash_restart,0.00,0,1,121,1,2620,2720,100
leader_crash_restart,0.00,0,1,124,1,2620,2720,100
leader_crash_restart,0.00,0,1,123,1,2620,2720,100
leader_crash_restart,0.00,0,1,125,1,2621,2720,99
leader_crash_restart,0.00,0,1,127,1,2722,2823,101
leader_crash_restart,0.00,0,1,126,1,2722,2823,101
leader_crash_restart,0.00,0,1,129,1,2722,2823,101
leader_crash_restart,0.00,0,1,128,1,2722,2823,101
leader_crash_restart,0.00,0,1,130,1,2722,2823,101
leader_crash_restart,0.00,0,1,132,1,2824,2924,100
leader_crash_restart,0.00,0,1,131,1,2824,2924,100
leader_crash_restart,0.00,0,1,134,1,2824,2924,100
leader_crash_restart,0.00,0,1,133,1,2824,2924,100
leader_crash_restart,0.00,0,1,135,1,2824,2924,100
leader_crash_restart,0.00,0,1,137,1,2926,3022,96
leader_crash_restart,0.00,0,1,136,1,2926,3023,97
leader_crash_restart,0.00,0,1,139,1,2926,3023,97
leader_crash_restart,0.00,0,1,138,1,2926,3023,97
leader_crash_restart,0.00,0,1,140,1,2926,3023,97
leader_crash_restart,0.00,0,1,142,1,3027,3123,96
leader_crash_restart,0.00,0,1,141,1,3027,3123,96
leader_crash_restart,0.00,0,1,144,1,3027,3123,96
leader_crash_restart,0.00,0,1,143,1,3027,3123,96
leader_crash_restart,0.00,0,1,145,1,3027,3123,96
leader_crash_restart,0.00,0,1,147,1,3131,3225,94
leader_crash_restart,0.00,0,1,146,1,3130,3226,96
leader_crash_restart,0.00,0,1,149,1,3131,3226,95
leader_crash_restart,0.00,0,1,148,1,3131,3226,95
leader_crash_restart,0.00,0,1,150,1,3131,3226,95
leader_crash_restart,0.00,0,1,152,1,3233,3329,96
leader_crash_restart,0.00,0,1,151,1,3233,3329,96
leader_crash_restart,0.00,0,1,154,1,3234,3329,95
leader_crash_restart,0.00,0,1,153,1,3233,3329,96
leader_crash_restart,0.00,0,1,155,1,3234,3329,95
leader_crash_restart,0.00,0,1,157,1,3335,3429,94
leader_crash_restart,0.00,0,1,156,1,3335,3429,94
leader_crash_restart,0.00,0,1,159,1,3335,3429,94
leader_crash_restart,0.00,0,1,158,1,3335,3429,94
leader_crash_restart,0.00,0,1,160,1,3336,3429,93
leader_crash_restart,0.00,0,1,162,1,3438,3520,82
leader_crash_restart,0.00,0,1,161,1,3438,3520,82
leader_crash_restart,0.00,0,1,164,1,3438,3520,82
leader_crash_restart,0.00,0,1,163,1,3438,3520,82
leader_crash_restart,0.00,0,1,165,1,3438,3520,82
leader_crash_restart,0.00,0,1,167,1,3539,3623,84
leader_crash_restart,0.00,0,1,166,1,3539,3623,84
leader_crash_restart,0.00,0,1,169,1,3539,3623,84
leader_crash_restart,0.00,0,1,168,1,3539,3623,84
leader_crash_restart,0.00,0,1,170,1,3540,3623,83
leader_crash_restart,0.00,0,1,172,1,3643,3727,84
leader_crash_restart,0.00,0,1,171,1,3643,3727,84
leader_crash_restart,0.00,0,1,174,1,3643,3727,84
leader_crash_restart,0.00,0,1,173,1,3643,3727,84
leader_crash_restart,0.00,0,1,175,1,3643,3727,84
leader_crash_restart,0.00,0,1,177,1,3745,3834,89
leader_crash_restart,0.00,0,1,176,1,3744,3834,90
leader_crash_restart,0.00,0,1,179,1,3745,3834,89
leader_crash_restart,0.00,0,1,178,1,3745,3834,89
leader_crash_restart,0.00,0,1,180,1,3746,3834,88
leader_crash_restart,0.00,0,1,182,1,3846,3929,83
leader_crash_restart,0.00,0,1,181,1,3846,3930,84
leader_crash_restart,0.00,0,1,184,1,3846,3930,84
leader_crash_restart,0.00,0,1,183,1,3846,3930,84
leader_crash_restart,0.00,0,1,185,1,3846,3930,84
leader_crash_restart,0.00,0,1,187,1,3948,4022,74
leader_crash_restart,0.00,0,1,186,1,3948,4023,75
leader_crash_restart,0.00,0,1,189,1,3948,4023,75
leader_crash_restart,0.00,0,1,188,1,3948,4023,75
leader_crash_restart,0.00,0,1,190,1,3948,4023,75
leader_crash_restart,0.00,0,1,192,1,4029,4135,106
leader_crash_restart,0.00,0,1,191,1,4029,4135,106
leader_crash_restart,0.00,0,1,194,1,4030,4135,105
leader_crash_restart,0.00,0,1,193,1,4030,4135,105
leader_crash_restart,0.00,0,1,195,1,4030,4135,105
leader_crash_restart,0.00,0,1,197,1,4151,4252,101
leader_crash_restart,0.00,0,1,196,1,4151,4252,101
leader_crash_restart,0.00,0,1,199,1,4151,4252,101
leader_crash_restart,0.00,0,1,198,1,4151,4252,101
leader_crash_restart,0.00,0,1,200,1,4151,4252,101
leader_crash_restart,0.00,0,1,202,1,4253,4345,92
leader_crash_restart,0.00,0,1,201,1,4253,4345,92
leader_crash_restart,0.00,0,1,204,1,4259,4348,89
leader_crash_restart,0.00,0,1,203,1,4258,4348,90
leader_crash_restart,0.00,0,1,205,1,4259,4348,89
leader_crash_restart,0.00,0,1,207,1,4348,4435,87
leader_crash_restart,0.00,0,1,206,1,4348,4435,87
leader_crash_restart,0.00,0,1,209,1,4348,4435,87
leader_crash_restart,0.00,0,1,208,1,4348,4436,88
leader_crash_restart,0.00,0,1,210,1,4348,4436,88
leader_crash_restart,0.00,0,1,212,1,4436,4531,95
leader_crash_restart,0.00,0,1,211,1,4436,4531,95
leader_crash_restart,0.00,0,1,214,1,4437,4531,94
leader_crash_restart,0.00,0,1,213,1,4436,4531,95
leader_crash_restart,0.00,0,1,215,1,4437,4531,94
leader_crash_restart,0.00,0,1,217,1,4542,4638,96
leader_crash_restart,0.00,0,1,216,1,4542,4639,97
leader_crash_restart,0.00,0,1,219,1,4542,4639,97
leader_crash_restart,0.00,0,1,218,1,4542,4639,97
leader_crash_restart,0.00,0,1,220,1,4542,4639,97
leader_crash_restart,0.00,0,1,222,1,4643,4733,90
leader_crash_restart,0.00,0,1,221,1,4643,4733,90
leader_crash_restart,0.00,0,1,224,1,4644,4733,89
leader_crash_restart,0.00,0,1,223,1,4644,4733,89
leader_crash_restart,0.00,0,1,225,1,4644,4733,89
leader_crash_restart,0.00,0,1,227,1,4745,4828,83
leader_crash_restart,0.00,0,1,226,1,4745,4829,84
leader_crash_restart,0.00,0,1,229,1,4745,4829,84
leader_crash_restart,0.00,0,1,228,1,4745,4829,84
leader_crash_restart,0.00,0,1,230,1,4745,4829,84
leader_crash_restart,0.00,0,1,232,1,4847,4935,88
leader_crash_restart,0.00,0,1,235,1,4847,4935,88
leader_crash_restart,0.00,0,1,231,1,4847,4935,88
leader_crash_restart,0.00,0,1,234,1,4847,4935,88
leader_crash_restart,0.00,0,1,233,1,4847,4935,88
leader_crash_restart,0.00,0,1,237,1,4949,5050,101
leader_crash_restart,0.00,0,1,240,1,4950,5050,100
leader_crash_restart,0.00,0,1,236,1,4948,5050,102
leader_crash_restart,0.00,0,1,239,1,4949,5050,101
leader_crash_restart,0.00,0,1,238,1,4949,5050,101
leader_crash_restart,0.00,0,1,242,1,5071,5136,65
leader_crash_restart,0.00,0,1,241,1,5071,5136,65
leader_crash_restart,0.00,0,1,244,1,5071,5136,65
leader_crash_restart,0.00,0,1,243,1,5071,5136,65
leader_crash_restart,0.00,0,1,245,1,5072,5136,64
leader_crash_restart,0.00,0,1,246,1,5153,5226,73
leader_crash_restart,0.00,0,1,1,2,2374,2423,49
leader_crash_restart,0.00,0,1,12,14,6185,6669,484
leader_crash_restart,0.00,0,1,14,14,6195,6669,474
leader_crash_restart,0.00,0,1,13,14,6185,6669,484
leader_crash_restart,0.00,0,1,16,14,6215,6669,454
leader_crash_restart,0.00,0,1,15,14,6208,6669,461
leader_crash_restart,0.00,0,1,2,1,459,501,42
leader_crash_restart,0.00,0,1,1,1,402,502,100
leader_crash_restart,0.00,0,1,3,1,487,502,15
leader_crash_restart,0.00,0,1,5,1,540,602,62
leader_crash_restart,0.00,0,1,4,1,518,602,84
leader_crash_restart,0.00,0,1,6,1,583,602,19
leader_crash_restart,0.00,0,1,8,1,620,702,82
leader_crash_restart,0.00,0,1,7,1,614,702,88
leader_crash_restart,0.00,0,1,9,1,699,702,3
leader_crash_restart,0.00,0,1,11,1,795,802,7
leader_crash_restart,0.00,0,1,10,1,709,802,93
leader_crash_restart,0.00,0,1,12,1,801,802,1
leader_crash_restart,0.00,0,1,14,1,811,902,91
leader_crash_restart,0.00,0,1,13,1,805,902,97
leader_crash_restart,0.00,0,1,15,1,891,903,12
leader_crash_restart,0.00,0,1,17,1,987,1002,15
leader_crash_restart,0.00,0,1,16,1,921,1002,81
leader_crash_restart,0.00,0,1,18,1,992,1002,10
leader_crash_restart,0.00,0,1,20,1,1023,1103,80
leader_crash_restart,0.00,0,1,19,1,1017,1103,86
leader_crash_restart,0.00,0,1,21,1,1102,1103,1
leader_crash_restart,0.00,0,1,23,1,1112,1203,91
leader_crash_restart,0.00,0,1,24,1,1199,1203,4
leader_crash_restart,0.00,0,1,22,1,1104,1203,99
leader_crash_restart,0.00,0,1,26,1,1287,1303,16
leader_crash_restart,0.00,0,1,25,1,1209,1304,95
leader_crash_restart,0.00,0,1,27,1,1295,1304,9
leader_crash_restart,0.00,0,1,29,1,1317,1404,87
leader_crash_restart,0.00,0,1,28,1,1305,1404,99
leader_crash_restart,0.00,0,1,30,1,1391,1404,13
leader_crash_restart,0.00,0,1,32,1,1487,1504,17
leader_crash_restart,0.00,0,1,31,1,1422,1504,82
leader_crash_restart,0.00,0,1,33,1,1498,1504,6
leader_crash_restart,0.00,0,1,35,1,1518,1605,87
leader_crash_restart,0.00,0,1,34,1,1509,1605,96
leader_crash_restart,0.00,0,1,36,1,1603,1605,2
leader_crash_restart,0.00,0,1,38,1,1690,1705,15
leader_crash_restart,0.00,0,1,37,1,1614,1705,91
leader_crash_restart,0.00,0,1,39,1,1699,1705,6
leader_crash_restart,0.00,0,1,41,1,1721,1805,84
leader_crash_restart,0.00,0,1,40,1,1710,1805,95
leader_crash_restart,0.00,0,1,42,1,1795,1806,11
leader_crash_restart,0.00,0,1,44,1,1891,1905,14
leader_crash_restart,0.00,0,1,43,1,1826,1906,80
leader_crash_restart,0.00,0,1,45,1,1902,1906,4
leader_crash_restart,0.00,0,1,47,1,1913,2007,94
leader_crash_restart,0.00,0,1,46,1,1907,2007,100
leader_crash_restart,0.00,0,1,48,1,1922,2007,85
leader_crash_restart,0.00,0,1,50,1,2094,2106,12
leader_crash_restart,0.00,0,1,49,1,2088,2107,19
leader_crash_restart,0.00,0,1,51,1,2104,2107,3
leader_crash_restart,0.00,0,1,53,1,2119,13563,11444
leader_crash_restart,0.00,0,1,52,1,2114,13563,11449
leader_crash_restart,0.00,0,1,55,1,2497,13563,11066
leader_crash_restart,0.00,0,1,54,1,2125,13563,11438
leader_crash_restart,0.00,0,1,82,1,5932,13563,7631
leader_crash_restart,0.00,0,1,98,1,7843,13563,5720
leader_crash_restart,0.00,0,1,57,1,2506,13563,11057
leader_crash_restart,0.00,0,1,115,29,13474,13563,89
leader_crash_restart,0.00,0,1,56,1,2501,13563,11062
leader_crash_restart,0.00,0,1,59,1,2883,13563,10680
leader_crash_restart,0.00,0,1,58,1,2879,13563,10684
leader_crash_restart,0.00,0,1,61,1,3261,13563,10302
leader_crash_restart,0.00,0,1,60,1,2888,13563,10675
leader_crash_restart,0.00,0,1,63,1,3270,13563,10293
leader_crash_restart,0.00,0,1,62,1,3265,13563,10298
leader_crash_restart,0.00,0,1,65,1,3646,13563,9917
leader_crash_restart,0.00,0,1,64,1,3642,13563,9921
leader_crash_restart,0.00,0,1,67,1,4024,13563,9539
leader_crash_restart,0.00,0,1,66,1,3652,13564,9912
leader_crash_restart,0.00,0,1,69,1,4033,13564,9531
leader_crash_restart,0.00,0,1,68,1,4028,13564,9536
leader_crash_restart,0.00,0,1,71,1,4409,13564,9155
leader_crash_restart,0.00,0,1,70,1,4406,13564,9158
leader_crash_restart,0.00,0,1,73,1,4787,13564,8777
leader_crash_restart,0.00,0,1,72,1,4415,13564,9149
leader_crash_restart,0.00,0,1,75,1,4796,13564,8768
leader_crash_restart,0.00,0,1,77,1,5172,13564,8392
leader_crash_restart,0.00,0,1,74,1,4791,13564,8773
leader_crash_restart,0.00,0,1,76,1,5169,13564,8395
leader_crash_restart,0.00,0,1,79,1,5550,13564,8014
leader_crash_restart,0.00,0,1,78,1,5178,13564,8386
leader_crash_restart,0.00,0,1,81,1,5559,13564,8005
leader_crash_restart,0.00,0,1,80,1,5553,13564,8011
leader_crash_restart,0.00,0,1,83,1,5935,13564,7629
leader_crash_restart,0.00,0,1,85,1,6314,13564,7250
leader_crash_restart,0.00,0,1,87,1,6323,13564,7241
leader_crash_restart,0.00,0,1,84,1,5941,13564,7623
leader_crash_restart,0.00,0,1,86,1,6317,13564,7247
leader_crash_restart,0.00,0,1,89,1,6699,13564,6865
leader_crash_restart,0.00,0,1,91,1,7077,13564,6487
leader_crash_restart,0.00,0,1,88,1,6696,13564,6868
leader_crash_restart,0.00,0,1,90,1,6705,13564,6859
leader_crash_restart,0.00,0,1,93,1,7086,13564,6478
leader_crash_restart,0.00,0,1,92,1,7080,13564,6484
leader_crash_restart,0.00,0,1,95,1,7462,13564,6102
leader_crash_restart,0.00,0,1,97,1,7840,13564,5724
leader_crash_restart,0.00,0,1,96,1,7467,13564,6097
leader_crash_restart,0.00,0,1,94,1,7458,13564,6106
leader_crash_restart,0.00,0,1,99,1,7849,13564,5715
leader_crash_restart,0.00,0,1,100,1,8221,13564,5343
leader_crash_restart,0.00,0,1,101,1,8224,13564,5340
leader_crash_restart,0.00,0,1,102,1,8231,13564,5333
leader_crash_restart,0.00,0,1,105,1,8612,13565,4953
leader_crash_restart,0.00,0,1,103,1,8603,13565,4962
leader_crash_restart,0.00,0,1,107,1,8991,13565,4574
leader_crash_restart,0.00,0,1,104,1,8606,13565,4959
leader_crash_restart,0.00,0,1,109,1,9372,13565,4193
leader_crash_restart,0.00,0,1,106,1,8991,13565,4574
leader_crash_restart,0.00,0,1,111,1,9377,13565,4188
leader_crash_restart,0.00,0,1,108,1,8995,13565,4570
leader_crash_restart,0.00,0,1,110,1,9372,13565,4193
leader_crash_restart,0.00,0,1,113,1,9754,13565,3811
leader_crash_restart,0.00,0,1,112,1,9754,13565,3811
leader_crash_restart,0.00,0,1,114,1,9758,13565,3807
leader_crash_restart,0.00,0,1,116,29,13508,13565,57
leader_crash_restart,0.00,0,1,117,29,13541,13565,24
leader_crash_restart,0.00,0,1,119,29,13590,13659,69
leader_crash_restart,0.00,0,1,118,29,13572,13659,87
leader_crash_restart,0.00,0,1,120,29,13655,13659,4
leader_crash_restart,0.00,0,1,122,29,13671,13759,88
leader_crash_restart,0.00,0,1,121,29,13666,13760,94
leader_crash_restart,0.00,0,1,123,29,13754,13760,6
leader_crash_restart,0.00,0,1,124,29,13765,13860,95
leader_crash_restart,0.00,0,1,125,29,13848,13860,12
leader_crash_restart,0.00,0,1,126,29,13853,13860,7
leader_crash_restart,0.00,0,1,128,29,13879,13959,80
leader_crash_restart,0.00,0,1,127,29,13863,13959,96
leader_crash_restart,0.00,0,1,129,29,13946,13959,13
leader_crash_restart,0.00,0,1,131,29,13977,14060,83
leader_crash_restart,0.00,0,1,130,29,13960,14061,101
leader_crash_restart,0.00,0,1,132,29,14045,14061,16
leader_crash_restart,0.00,0,1,133,29,14076,14161,85
leader_crash_restart,0.00,0,1,134,29,14142,14161,19
leader_crash_restart,0.00,0,1,135,29,14158,14161,3
leader_crash_restart,0.00,0,1,137,29,14173,14261,88
leader_crash_restart,0.00,0,1,136,29,14169,14262,93
leader_crash_restart,0.00,0,1,138,29,14258,14262,4
leader_crash_restart,0.00,0,1,139,29,14268,14361,93
leader_crash_restart,0.00,0,1,140,29,14350,14362,12
leader_crash_restart,0.00,0,1,141,29,14354,14362,8
leader_crash_restart,0.00,0,1,142,29,14365,14462,97
leader_crash_restart,0.00,0,1,143,29,14381,14462,81
leader_crash_restart,0.00,0,1,144,29,14450,14462,12
leader_crash_restart,0.00,0,1,145,29,14463,14562,99
leader_crash_restart,0.00,0,1,146,29,14480,14563,83
leader_crash_restart,0.00,0,1,147,29,14547,14563,16
leader_crash_restart,0.00,0,1,149,29,14645,14662,17
leader_crash_restart,0.00,0,1,148,29,14578,14663,85
leader_crash_restart,0.00,0,1,150,29,14662,14763,101
leader_crash_restart,0.00,0,1,151,29,14675,14763,88
leader_crash_restart,0.00,0,1,152,29,14760,14763,3
leader_crash_restart,0.00,0,1,154,29,14844,14863,19
leader_crash_restart,0.00,0,1,153,29,14770,14863,93
leader_crash_restart,0.00,0,1,155,29,14857,14863,6
leader_crash_restart,0.00,0,1,157,29,14875,14965,90
leader_crash_restart,0.00,0,1,156,29,14867,14965,98
leader_crash_restart,0.00,0,1,158,29,14952,14965,13
leader_crash_restart,0.00,0,1,160,36,3049,3110,61
leader_crash_restart,0.00,0,1,2,1,341,420,79
leader_crash_restart,0.00,0,1,1,1,319,420,101
leader_crash_restart,0.00,0,1,3,1,387,420,33
leader_crash_restart,0.00,0,1,5,1,469,521,52
leader_crash_restart,0.00,0,1,4,1,423,521,98
leader_crash_restart,0.00,0,1,6,1,501,521,20
leader_crash_restart,0.00,0,1,8,1,551,616,65
leader_crash_restart,0.00,0,1,7,1,532,616,84
leader_crash_restart,0.00,0,1,9,1,604,638,34
leader_crash_restart,0.00,0,1,10,6,1778,1830,52
leader_crash_restart,0.00,0,1,12,6,1859,1946,87
leader_crash_restart,0.00,0,1,11,6,1831,1946,115
leader_crash_restart,0.00,0,1,13,6,1859,1946,87
leader_crash_restart,0.00,0,1,14,6,2013,2048,35
leader_crash_restart,0.00,0,1,16,6,2041,2133,92
leader_crash_restart,0.00,0,1,15,6,2040,2133,93
leader_crash_restart,0.00,0,1,17,6,2094,2133,39
leader_crash_restart,0.00,0,1,18,6,2176,2224,48
leader_crash_restart,0.00,0,1,19,6,2221,2315,94
leader_crash_restart,0.00,0,1,21,6,2257,2325,68
leader_crash_restart,0.00,0,1,20,6,2224,2325,101
leader_crash_restart,0.00,0,1,23,6,2404,2440,36
leader_crash_restart,0.00,0,1,22,6,2338,2440,102
leader_crash_restart,0.00,0,1,24,6,2406,2440,34
leader_crash_restart,0.00,0,1,26,6,2487,2534,47
leader_crash_restart,0.00,0,1,25,6,2485,2534,49
leader_crash_restart,0.00,0,1,27,6,2520,2534,14
leader_crash_restart,0.00,0,1,29,6,2567,2622,55
leader_crash_restart,0.00,0,1,28,6,2551,2623,72
leader_crash_restart,0.00,0,1,30,6,2569,2623,54
leader_crash_restart,0.00,0,1,32,6,2650,2733,83
leader_crash_restart,0.00,0,1,31,6,2633,2734,101
leader_crash_restart,0.00,0,1,33,6,2650,2734,84
leader_crash_restart,0.00,0,1,34,6,2814,2841,27
leader_crash_restart,0.00,0,1,36,6,2832,2928,96
leader_crash_restart,0.00,0,1,35,6,2832,2928,96
leader_crash_restart,0.00,0,1,37,6,2845,2928,83
leader_crash_restart,0.00,0,1,39,6,3013,3037,24
leader_crash_restart,0.00,0,1,38,6,3013,3037,24
leader_crash_restart,0.00,0,1,40,6,3027,3052,25
leader_crash_restart,0.00,0,1,42,6,3044,3138,94
leader_crash_restart,0.00,0,1,41,6,3044,3138,94
leader_crash_restart,0.00,0,1,43,6,3058,3138,80
leader_crash_restart,0.00,0,1,44,6,3138,3231,93
leader_crash_restart,0.00,0,1,46,6,3225,3249,24
leader_crash_restart,0.00,0,1,45,6,3225,3249,24
leader_crash_restart,0.00,0,1,48,6,3255,3334,79
leader_crash_restart,0.00,0,1,47,6,3255,3334,79
leader_crash_restart,0.00,0,1,49,6,3320,3347,27
leader_crash_restart,0.00,0,1,50,6,3336,3432,96
leader_crash_restart,0.00,0,1,51,6,3336,3432,96
leader_crash_restart,0.00,0,1,52,6,3351,3432,81
leader_crash_restart,0.00,0,1,53,6,3432,3533,101
leader_crash_restart,0.00,0,1,55,6,3517,3554,37
leader_crash_restart,0.00,0,1,54,6,3517,3555,38
leader_crash_restart,0.00,0,1,57,6,3599,3639,40
leader_crash_restart,0.00,0,1,56,6,3599,3639,40
leader_crash_restart,0.00,0,1,58,6,3614,3639,25
leader_crash_restart,0.00,0,1,60,6,3680,3719,39
leader_crash_restart,0.00,0,1,59,6,3645,3719,74
leader_crash_restart,0.00,0,1,61,6,3680,3719,39
leader_crash_restart,0.00,0,1,62,6,3726,3733,7
leader_crash_restart,0.00,0,1,64,6,3760,3834,74
leader_crash_restart,0.00,0,1,63,6,3736,3834,98
leader_crash_restart,0.00,0,1,65,6,3760,3834,74
leader_crash_restart,0.00,0,1,67,6,3843,3932,89
leader_crash_restart,0.00,0,1,66,6,3843,3932,89
leader_crash_restart,0.00,0,1,68,6,3919,3948,29
leader_crash_restart,0.00,0,1,70,6,4024,4037,13
leader_crash_restart,0.00,0,1,69,6,3949,4037,88
leader_crash_restart,0.00,0,1,71,6,4024,4037,13
leader_crash_restart,0.00,0,1,73,6,4055,4128,73
leader_crash_restart,0.00,0,1,72,6,4055,4128,73
leader_crash_restart,0.00,0,1,74,6,4131,4224,93
leader_crash_restart,0.00,0,1,76,6,4136,4231,95
leader_crash_restart,0.00,0,1,75,6,4136,4231,95
leader_crash_restart,0.00,0,1,78,6,4317,4321,4
leader_crash_restart,0.00,0,1,77,6,4312,4321,9
leader_crash_restart,0.00,0,1,79,6,4317,4321,4
leader_crash_restart,0.00,0,1,81,6,4327,4341,14
leader_crash_restart,0.00,0,1,80,6,4322,4341,19
leader_crash_restart,0.00,0,1,82,6,4327,4341,14
leader_crash_restart,0.00,0,1,84,6,4358,4521,163
leader_crash_restart,0.00,0,1,83,6,4353,4521,168
leader_crash_restart,0.00,0,1,85,6,4358,4521,163
leader_crash_restart,0.00,0,1,87,6,4539,4641,102
leader_crash_restart,0.00,0,1,86,6,4534,4641,107
leader_crash_restart,0.00,0,1,88,6,4539,4641,102
leader_crash_restart,0.00,0,1,89,6,4716,4739,23
leader_crash_restart,0.00,0,1,91,6,4721,4753,32
leader_crash_restart,0.00,0,1,90,6,4721,4753,32
leader_crash_restart,0.00,0,1,93,6,4802,4832,30
leader_crash_restart,0.00,0,1,92,6,4746,4832,86
leader_crash_restart,0.00,0,1,94,6,4802,4832,30
leader_crash_restart,0.00,0,1,96,6,4833,4856,23
leader_crash_restart,0.00,0,1,95,6,4833,4856,23
leader_crash_restart,0.00,0,1,98,6,4864,4947,83
leader_crash_restart,0.00,0,1,97,6,4864,4947,83
leader_crash_restart,0.00,0,1,99,6,4928,4953,25
leader_crash_restart,0.00,0,1,100,6,4958,5044,86
leader_crash_restart,0.00,0,1,102,6,5045,5146,101
leader_crash_restart,0.00,0,1,101,6,5045,5146,101
leader_crash_restart,0.00,0,1,103,6,5139,5235,96
leader_crash_restart,0.00,0,1,105,6,5226,5339,113
leader_crash_restart,0.00,0,1,104,6,5226,5339,113
leader_crash_restart,0.00,0,1,106,6,5321,5339,18
leader_crash_restart,0.00,0,1,108,6,5408,5457,49
leader_crash_restart,0.00,0,1,107,6,5351,5457,106
leader_crash_restart,0.00,0,1,109,6,5408,5457,49
leader_crash_restart,0.00,0,1,111,6,5489,5544,55
leader_crash_restart,0.00,0,1,110,6,5489,5544,55
leader_crash_restart,0.00,0,1,112,6,5532,5544,12
leader_crash_restart,0.00,0,1,114,6,5570,5650,80
leader_crash_restart,0.00,0,1,113,6,5563,5650,87
leader_crash_restart,0.00,0,1,115,6,5570,5650,80
leader_crash_restart,0.00,0,1,117,6,5652,5739,87
leader_crash_restart,0.00,0,1,116,6,5652,5740,88
leader_crash_restart,0.00,0,1,119,6,5834,5857,23
leader_crash_restart,0.00,0,1,118,6,5745,5857,112
leader_crash_restart,0.00,0,1,120,6,5834,5857,23
leader_crash_restart,0.00,0,1,122,6,5865,5935,70
leader_crash_restart,0.00,0,1,121,6,5865,5941,76
leader_crash_restart,0.00,0,1,123,6,5926,5959,33
leader_crash_restart,0.00,0,1,125,6,5946,6036,90
leader_crash_restart,0.00,0,1,124,6,5946,6037,91
leader_crash_restart,0.00,0,1,126,6,6008,6037,29
leader_crash_restart,0.00,0,1,127,6,6039,6148,109
leader_crash_restart,0.00,0,1,129,6,6127,6252,125
leader_crash_restart,0.00,0,1,128,6,6127,6252,125
leader_crash_restart,0.00,0,1,130,6,6221,6252,31
leader_crash_restart,0.00,0,1,1,1,303,402,99
leader_crash_restart,0.00,0,1,2,2,404,501,97
leader_crash_restart,0.00,0,1,3,3,403,502,99
leader_crash_restart,0.00,0,1,4,6,3341,3413,72
leader_crash_restart,0.00,0,1,5,6,4137,4221,84
leader_crash_restart,0.00,0,1,6,6,4323,4421,98
leader_crash_restart,0.00,0,1,1,1,407,501,94
leader_crash_restart,0.00,0,1,2,1,1114,1204,90
leader_crash_restart,0.00,0,1,3,7,403,501,98
leader_crash_restart,0.00,0,1,4,7,607,703,96
leader_crash_restart,0.00,0,1,5,7,1314,1404,90
leader_crash_restart,0.00,0,1,6,13,452,502,50
leader_crash_restart,0.00,0,1,7,13,616,704,88
leader_crash_restart,0.00,0,1,8,13,1180,1205,25
leader_crash_restart,0.00,0,1,9,20,503,602,99
leader_crash_restart,0.00,0,1,10,20,2734,2811,77
leader_crash_restart,0.00,0,1,11,20,3362,3414,52
leader_crash_restart,0.00,0,1,12,27,503,601,98
leader_crash_restart,0.00,0,1,13,27,705,804,99
leader_crash_restart,0.00,0,1,14,27,1400,1406,6
leader_crash_restart,0.00,0,1,15,34,503,602,99
leader_crash_restart,0.00,0,1,16,34,2723,2809,86
leader_crash_restart,0.00,0,1,1,1,402,501,99
leader_crash_restart,0.00,0,1,2,1,1156,1204,48
leader_crash_restart,0.00,0,1,3,3,403,501,98
leader_crash_restart,0.00,0,1,4,3,609,701,92
leader_crash_restart,0.00,0,1,1,1,407,503,96
leader_crash_restart,0.00,0,1,3,5,405,501,96
leader_crash_restart,0.00,0,1,10,30,668,702,34
leader_crash_restart,0.00,0,1,11,31,2461,2509,48
leader_crash_restart,0.00,0,1,12,32,1900,1904,4
leader_crash_restart,0.00,0,1,13,33,449,502,53
leader_crash_restart,0.00,0,1,15,39,397,402,5
leader_crash_restart,0.00,0,1,19,51,1400,1405,5
leader_crash_restart,0.00,0,1,22,58,498,501,3
leader_crash_restart,0.00,0,1,24,64,792,803,11
leader_crash_restart,0.00,0,1,30,90,430,703,273
leader_crash_restart,0.00,0,1,2,1,339,423,84
leader_crash_restart,0.00,0,1,1,1,339,423,84
leader_crash_restart,0.00,0,1,4,1,339,423,84
leader_crash_restart,0.00,0,1,3,1,339,423,84
leader_crash_restart,0.00,0,1,5,1,339,423,84
leader_crash_restart,0.00,0,1,7,1,441,520,79
leader_crash_restart,0.00,0,1,6,1,441,521,80
leader_crash_restart,0.00,0,1,9,1,441,521,80
leader_crash_restart,0.00,0,1,8,1,441,521,80
leader_crash_restart,0.00,0,1,10,1,441,521,80
leader_crash_restart,0.00,0,1,12,1,522,534,12
leader_crash_restart,0.00,0,1,11,1,522,534,12
leader_crash_restart,0.00,0,1,14,1,522,534,12
leader_crash_restart,0.00,0,1,13,1,522,534,12
leader_crash_restart,0.00,0,1,15,1,522,534,12
leader_crash_restart,0.00,0,1,16,1,542,624,82
leader_crash_restart,0.00,0,1,17,1,542,624,82
leader_crash_restart,0.00,0,1,19,1,542,624,82
leader_crash_restart,0.00,0,1,18,1,542,624,82
leader_crash_restart,0.00,0,1,20,1,542,624,82
leader_crash_restart,0.00,0,1,22,1,644,726,82
leader_crash_restart,0.00,0,1,21,1,644,726,82
leader_crash_restart,0.00,0,1,24,1,644,726,82
leader_crash_restart,0.00,0,1,23,1,644,726,82
leader_crash_restart,0.00,0,1,25,1,644,726,82
leader_crash_restart,0.00,0,1,27,1,745,828,83
leader_crash_restart,0.00,0,1,26,1,745,828,83
leader_crash_restart,0.00,0,1,29,1,745,828,83
leader_crash_restart,0.00,0,1,28,1,745,828,83
leader_crash_restart,0.00,0,1,30,1,745,828,83
leader_crash_restart,0.00,0,1,32,1,848,920,72
leader_crash_restart,0.00,0,1,31,1,847,920,73
leader_crash_restart,0.00,0,1,34,1,848,920,72
leader_crash_restart,0.00,0,1,33,1,848,920,72
leader_crash_restart,0.00,0,1,35,1,848,920,72
leader_crash_restart,0.00,0,1,37,1,929,1041,112
leader_crash_restart,0.00,0,1,36,1,929,1042,113
leader_crash_restart,0.00,0,1,39,1,929,1042,113
leader_crash_restart,0.00,0,1,38,1,929,1042,113
leader_crash_restart,0.00,0,1,40,1,929,1042,113
leader_crash_restart,0.00,0,1,42,1,1051,1134,83
leader_crash_restart,0.00,0,1,41,1,1051,1134,83
leader_crash_restart,0.00,0,1,44,1,1051,1134,83
leader_crash_restart,0.00,0,1,45,1,1051,1134,83
leader_crash_restart,0.00,0,1,43,1,1051,1134,83
leader_crash_restart,0.00,0,1,47,1,1153,1230,77
leader_crash_restart,0.00,0,1,46,1,1153,1230,77
leader_crash_restart,0.00,0,1,49,1,1153,1230,77
leader_crash_restart,0.00,0,1,48,1,1153,1230,77
leader_crash_restart,0.00,0,1,50,1,1153,1230,77
leader_crash_restart,0.00,0,1,52,1,1234,1328,94
leader_crash_restart,0.00,0,1,51,1,1234,1328,94
leader_crash_restart,0.00,0,1,54,1,1234,1328,94
leader_crash_restart,0.00,0,1,53,1,1234,1328,94
leader_crash_restart,0.00,0,1,55,1,1234,1328,94
leader_crash_restart,0.00,0,1,57,1,1337,1431,94
leader_crash_restart,0.00,0,1,56,1,1337,1431,94
leader_crash_restart,0.00,0,1,59,1,1337,1431,94
leader_crash_restart,0.00,0,1,58,1,1337,1431,94
leader_crash_restart,0.00,0,1,60,1,1337,1431,94
leader_crash_restart,0.00,0,1,62,1,1440,1528,88
leader_crash_restart,0.00,0,1,61,1,1440,1528,88
leader_crash_restart,0.00,0,1,64,1,1440,1528,88
leader_crash_restart,0.00,0,1,63,1,1440,1528,88
leader_crash_restart,0.00,0,1,65,1,1440,1528,88
leader_crash_restart,0.00,0,1,67,1,1541,1637,96
leader_crash_restart,0.00,0,1,66,1,1541,1637,96
leader_crash_restart,0.00,0,1,69,1,1541,1637,96
leader_crash_restart,0.00,0,1,68,1,1541,1637,96
leader_crash_restart,0.00,0,1,70,1,1541,1637,96
leader_crash_restart,0.00,0,1,72,1,1644,1740,96
leader_crash_restart,0.00,0,1,71,1,1644,1740,96
leader_crash_restart,0.00,0,1,74,1,1644,1740,96
leader_crash_restart,0.00,0,1,73,1,1644,1740,96
leader_crash_restart,0.00,0,1,75,1,1644,1740,96
leader_crash_restart,0.00,0,1,77,1,1745,1834,89
leader_crash_restart,0.00,0,1,76,1,1745,1834,89
leader_crash_restart,0.00,0,1,79,1,1745,1834,89
leader_crash_restart,0.00,0,1,78,1,1745,1834,89
leader_crash_restart,0.00,0,1,80,1,1746,1834,88
leader_crash_restart,0.00,0,1,82,1,1847,1929,82
leader_crash_restart,0.00,0,1,81,1,1847,1929,82
leader_crash_restart,0.00,0,1,83,1,1847,1929,82
leader_crash_restart,0.00,0,1,84,1,1847,1929,82
leader_crash_restart,0.00,0,1,85,1,1847,1929,82
leader_crash_restart,0.00,0,1,87,1,1949,2032,83
leader_crash_restart,0.00,0,1,86,1,1949,2033,84
leader_crash_restart,0.00,0,1,89,1,1949,2033,84
leader_crash_restart,0.00,0,1,88,1,1949,2033,84
leader_crash_restart,0.00,0,1,90,1,1949,2033,84
leader_crash_restart,0.00,0,1,92,1,2051,2134,83
leader_crash_restart,0.00,0,1,91,1,2051,2134,83
leader_crash_restart,0.00,0,1,94,1,2051,2134,83
leader_crash_restart,0.00,0,1,93,1,2051,2134,83
leader_crash_restart,0.00,0,1,95,1,2051,2134,83
leader_crash_restart,0.00,0,1,97,1,2153,2232,79
leader_crash_restart,0.00,0,1,96,1,2153,2232,79
leader_crash_restart,0.00,0,1,99,1,2153,2232,79
leader_crash_restart,0.00,0,1,100,1,2153,2232,79
leader_crash_restart,0.00,0,1,98,1,2153,2232,79
leader_crash_restart,0.00,0,1,102,1,2234,2337,103
leader_crash_restart,0.00,0,1,101,1,2234,2337,103
leader_crash_restart,0.00,0,1,104,1,2234,2337,103
leader_crash_restart,0.00,0,1,103,1,2234,2337,103
leader_crash_restart,0.00,0,1,105,1,2235,2337,102
leader_crash_restart,0.00,0,1,107,1,2356,2426,70
leader_crash_restart,0.00,0,1,106,1,2356,2426,70
leader_crash_restart,0.00,0,1,109,1,2356,2426,70
leader_crash_restart,0.00,0,1,108,1,2356,2426,70
leader_crash_restart,0.00,0,1,110,1,2356,2426,70
leader_crash_restart,0.00,0,1,112,1,2438,2527,89
leader_crash_restart,0.00,0,1,111,1,2438,2527,89
leader_crash_restart,0.00,0,1,114,1,2438,2527,89
leader_crash_restart,0.00,0,1,113,1,2438,2527,89
leader_crash_restart,0.00,0,1,115,1,2438,2527,89
leader_crash_restart,0.00,0,1,117,1,2540,2638,98
leader_crash_restart,0.00,0,1,116,1,2540,2638,98
leader_crash_restart,0.00,0,1,119,1,2540,2638,98
leader_crash_restart,0.00,0,1,118,1,2540,2638,98
leader_crash_restart,0.00,0,1,120,1,2540,2638,98
leader_crash_restart,0.00,0,1,122,1,2641,2731,90
leader_crash_restart,0.00,0,1,121,1,2641,2731,90
leader_crash_restart,0.00,0,1,124,1,2642,2731,89
leader_crash_restart,0.00,0,1,125,1,2642,2731,89
leader_crash_restart,0.00,0,1,123,1,2642,2731,89
leader_crash_restart,0.00,0,1,127,1,2742,2828,86
leader_crash_restart,0.00,0,1,126,1,2742,2828,86
leader_crash_restart,0.00,0,1,129,1,2742,2828,86
leader_crash_restart,0.00,0,1,128,1,2742,2828,86
leader_crash_restart,0.00,0,1,130,1,2743,2828,85
leader_crash_restart,0.00,0,1,132,1,2844,2931,87
leader_crash_restart,0.00,0,1,131,1,2844,2931,87
leader_crash_restart,0.00,0,1,134,1,2844,2931,87
leader_crash_restart,0.00,0,1,133,1,2844,2931,87
leader_crash_restart,0.00,0,1,135,1,2844,2931,87
leader_crash_restart,0.00,0,1,137,1,2946,3036,90
leader_crash_restart,0.00,0,1,139,1,2946,3037,91
leader_crash_restart,0.00,0,1,138,1,2946,3037,91
leader_crash_restart,0.00,0,1,136,1,2945,3037,92
leader_crash_restart,0.00,0,1,140,1,2946,3037,91
leader_crash_restart,0.00,0,1,142,1,3047,3141,94
leader_crash_restart,0.00,0,1,141,1,3047,3141,94
leader_crash_restart,0.00,0,1,144,1,3047,3141,94
leader_crash_restart,0.00,0,1,143,1,3047,3141,94
leader_crash_restart,0.00,0,1,145,1,3047,3141,94
leader_crash_restart,0.00,0,1,147,1,3148,3239,91
leader_crash_restart,0.00,0,1,146,1,3148,3239,91
leader_crash_restart,0.00,0,1,149,1,3148,3239,91
leader_crash_restart,0.00,0,1,148,1,3148,3239,91
leader_crash_restart,0.00,0,1,150,1,3148,3239,91
leader_crash_restart,0.00,0,1,152,1,3249,3335,86
leader_crash_restart,0.00,0,1,151,1,3249,3335,86
leader_crash_restart,0.00,0,1,154,1,3250,3335,85
leader_crash_restart,0.00,0,1,153,1,3250,3335,85
leader_crash_restart,0.00,0,1,155,1,3250,3335,85
leader_crash_restart,0.00,0,1,157,1,3351,3443,92
leader_crash_restart,0.00,0,1,156,1,3351,3443,92
leader_crash_restart,0.00,0,1,159,1,3351,3443,92
leader_crash_restart,0.00,0,1,158,1,3351,3443,92
leader_crash_restart,0.00,0,1,160,1,3351,3443,92
leader_crash_restart,0.00,0,1,162,1,3452,3535,83
leader_crash_restart,0.00,0,1,161,1,3452,3536,84
leader_crash_restart,0.00,0,1,164,1,3452,3536,84
leader_crash_restart,0.00,0,1,163,1,3452,3536,84
leader_crash_restart,0.00,0,1,165,1,3453,3536,83
leader_crash_restart,0.00,0,1,167,1,3554,3643,89
leader_crash_restart,0.00,0,1,166,1,3554,3644,90
leader_crash_restart,0.00,0,1,169,1,3554,3644,90
leader_crash_restart,0.00,0,1,168,1,3554,3644,90
leader_crash_restart,0.00,0,1,170,1,3554,3644,90
leader_crash_restart,0.00,0,1,172,1,3655,3732,77
leader_crash_restart,0.00,0,1,171,1,3655,3732,77
leader_crash_restart,0.00,0,1,174,1,3656,3732,76
leader_crash_restart,0.00,0,1,173,1,3655,3732,77
leader_crash_restart,0.00,0,1,175,1,3656,3732,76
leader_crash_restart,0.00,0,1,177,1,3737,3838,101
leader_crash_restart,0.00,0,1,176,1,3737,3838,101
leader_crash_restart,0.00,0,1,179,1,3737,3838,101
leader_crash_restart,0.00,0,1,178,1,3737,3838,101
leader_crash_restart,0.00,0,1,180,1,3737,3838,101
leader_crash_restart,0.00,0,1,182,1,3858,3948,90
leader_crash_restart,0.00,0,1,181,1,3858,3948,90
leader_crash_restart,0.00,0,1,184,1,3858,3948,90
leader_crash_restart,0.00,0,1,183,1,3858,3948,90
leader_crash_restart,0.00,0,1,185,1,3858,3948,90
leader_crash_restart,0.00,0,1,187,1,3960,4040,80
leader_crash_restart,0.00,0,1,186,1,3960,4040,80
leader_crash_restart,0.00,0,1,189,1,3960,4040,80
leader_crash_restart,0.00,0,1,188,1,3960,4040,80
leader_crash_restart,0.00,0,1,190,1,3960,4040,80
leader_crash_restart,0.00,0,1,192,1,4041,4144,103
leader_crash_restart,0.00,0,1,194,1,4042,4144,102
leader_crash_restart,0.00,0,1,191,1,4041,4144,103
leader_crash_restart,0.00,0,1,193,1,4041,4144,103
leader_crash_restart,0.00,0,1,195,1,4042,4144,102
leader_crash_restart,0.00,0,1,197,1,4163,4252,89
leader_crash_restart,0.00,0,1,196,1,4163,4252,89
leader_crash_restart,0.00,0,1,199,1,4163,4252,89
leader_crash_restart,0.00,0,1,198,1,4163,4252,89
leader_crash_restart,0.00,0,1,200,1,4163,4252,89
leader_crash_restart,0.00,0,1,202,1,4264,4345,81
leader_crash_restart,0.00,0,1,201,1,4264,4345,81
leader_crash_restart,0.00,0,1,204,1,4264,4345,81
leader_crash_restart,0.00,0,1,203,1,4264,4345,81
leader_crash_restart,0.00,0,1,205,1,4264,4345,81
leader_crash_restart,0.00,0,1,207,1,4366,4436,70
leader_crash_restart,0.00,0,1,206,1,4366,4437,71
leader_crash_restart,0.00,0,1,209,1,4366,4437,71
leader_crash_restart,0.00,0,1,208,1,4366,4437,71
leader_crash_restart,0.00,0,1,210,1,4366,4437,71
leader_crash_restart,0.00,0,1,212,1,4447,4540,93
leader_crash_restart,0.00,0,1,214,1,4447,4540,93
leader_crash_restart,0.00,0,1,213,1,4447,4540,93
leader_crash_restart,0.00,0,1,211,1,4447,4540,93
leader_crash_restart,0.00,0,1,215,1,4448,4540,92
leader_crash_restart,0.00,0,1,217,1,4548,4638,90
leader_crash_restart,0.00,0,1,216,1,4548,4638,90
leader_crash_restart,0.00,0,1,219,1,4548,4638,90
leader_crash_restart,0.00,0,1,218,1,4548,4638,90
leader_crash_restart,0.00,0,1,220,1,4548,4638,90
leader_crash_restart,0.00,0,1,222,1,4650,4743,93
leader_crash_restart,0.00,0,1,221,1,4650,4743,93
leader_crash_restart,0.00,0,1,224,1,4650,4743,93
leader_crash_restart,0.00,0,1,223,1,4650,4743,93
leader_crash_restart,0.00,0,1,225,1,4651,4743,92
leader_crash_restart,0.00,0,1,227,1,4752,4844,92
leader_crash_restart,0.00,0,1,226,1,4752,4844,92
leader_crash_restart,0.00,0,1,229,1,4752,4844,92
leader_crash_restart,0.00,0,1,228,1,4752,4844,92
leader_crash_restart,0.00,0,1,230,1,4753,4844,91
leader_crash_restart,0.00,0,1,232,1,4853,4935,82
leader_crash_restart,0.00,0,1,231,1,4853,4935,82
leader_crash_restart,0.00,0,1,234,1,4853,4935,82
leader_crash_restart,0.00,0,1,233,1,4853,4935,82
leader_crash_restart,0.00,0,1,235,1,4853,4935,82
leader_crash_restart,0.00,0,1,237,1,4954,5046,92
leader_crash_restart,0.00,0,1,236,1,4954,5047,93
leader_crash_restart,0.00,0,1,239,1,4954,5047,93
leader_crash_restart,0.00,0,1,240,1,4954,5047,93
leader_crash_restart,0.00,0,1,238,1,4954,5047,93
leader_crash_restart,0.00,0,1,242,1,5057,5149,92
leader_crash_restart,0.00,0,1,241,1,5057,5149,92
leader_crash_restart,0.00,0,1,244,1,5058,5149,91
leader_crash_restart,0.00,0,1,243,1,5057,5149,92
leader_crash_restart,0.00,0,1,245,1,5058,5149,91
leader_crash_restart,0.00,0,1,246,1,5160,5233,73
leader_crash_restart,0.00,0,1,1,1,354,409,55
leader_crash_restart,0.00,0,1,2,3,1216,1312,96
leader_crash_restart,0.00,0,1,3,4,1954,2060,106
leader_crash_restart,0.00,0,1,5,4,2129,2145,16
leader_crash_restart,0.00,0,1,4,4,2129,2145,16
leader_crash_restart,0.00,0,1,6,4,2131,2145,14
leader_crash_restart,0.00,0,1,2,1,480,501,21
leader_crash_restart,0.00,0,1,1,1,458,501,43
leader_crash_restart,0.00,0,1,3,1,486,501,15
leader_crash_restart,0.00,0,1,5,1,517,602,85
leader_crash_restart,0.00,0,1,4,1,510,602,92
leader_crash_restart,0.00,0,1,6,1,538,602,64
leader_crash_restart,0.00,0,1,8,1,691,703,12
leader_crash_restart,0.00,0,1,7,1,620,703,83
leader_crash_restart,0.00,0,1,9,1,698,703,5
leader_crash_restart,0.00,0,1,11,1,722,802,80
leader_crash_restart,0.00,0,1,10,1,708,802,94
leader_crash_restart,0.00,0,1,12,1,801,802,1
leader_crash_restart,0.00,0,1,14,1,811,902,91
leader_crash_restart,0.00,0,1,13,1,804,903,99
leader_crash_restart,0.00,0,1,15,1,891,903,12
leader_crash_restart,0.00,0,1,17,1,991,1002,11
leader_crash_restart,0.00,0,1,16,1,921,1003,82
leader_crash_restart,0.00,0,1,18,1,994,1003,9
leader_crash_restart,0.00,0,1,19,1,1005,1006,1
leader_crash_restart,0.00,0,1,21,1,1021,1103,82
leader_crash_restart,0.00,0,1,20,1,1017,1103,86
leader_crash_restart,0.00,0,1,22,1,1027,1103,76
leader_crash_restart,0.00,0,1,23,1,1108,1204,96
leader_crash_restart,0.00,0,1,24,1,1200,1204,4
leader_crash_restart,0.00,0,1,25,1,1204,1204,0
leader_crash_restart,0.00,0,1,27,1,1214,1304,90
leader_crash_restart,0.00,0,1,28,1,1289,1304,15
leader_crash_restart,0.00,0,1,26,1,1210,1304,94
leader_crash_restart,0.00,0,1,30,1,1393,1404,11
leader_crash_restart,0.00,0,1,29,1,1320,1404,84
leader_crash_restart,0.00,0,1,31,1,1396,1405,9
leader_crash_restart,0.00,0,1,32,1,1406,1408,2
leader_crash_restart,0.00,0,1,34,1,1423,1509,86
leader_crash_restart,0.00,0,1,33,1,1417,1509,92
leader_crash_restart,0.00,0,1,35,1,1501,1509,8
leader_crash_restart,0.00,0,1,36,1,1512,1606,94
leader_crash_restart,0.00,0,1,37,1,1604,1606,2
leader_crash_restart,0.00,0,1,38,1,1608,1706,98
leader_crash_restart,0.00,0,1,39,1,1614,1706,92
leader_crash_restart,0.00,0,1,40,1,1693,1706,13
leader_crash_restart,0.00,0,1,42,1,1796,1815,19
leader_crash_restart,0.00,0,1,41,1,1724,1815,91
leader_crash_restart,0.00,0,1,43,1,1798,1815,17
leader_crash_restart,0.00,0,1,45,1,1835,1914,79
leader_crash_restart,0.00,0,1,44,1,1832,1915,83
leader_crash_restart,0.00,0,1,46,1,1908,1915,7
leader_crash_restart,0.00,0,1,48,1,1925,2014,89
leader_crash_restart,0.00,0,1,47,1,1919,2014,95
leader_crash_restart,0.00,0,1,49,1,1934,2014,80
leader_crash_restart,0.00,0,1,50,1,2015,2015,0
leader_crash_restart,0.00,0,1,52,1,2100,2115,15
leader_crash_restart,0.00,0,1,51,1,2026,2115,89
leader_crash_restart,0.00,0,1,53,1,2107,2115,8
leader_crash_restart,0.00,0,1,55,1,2131,2215,84
leader_crash_restart,0.00,0,1,54,1,2117,2215,98
leader_crash_restart,0.00,0,1,56,1,2207,2215,8
leader_crash_restart,0.00,0,1,58,1,2298,2316,18
leader_crash_restart,0.00,0,1,57,1,2218,2316,98
leader_crash_restart,0.00,0,1,59,1,2312,2316,4
leader_crash_restart,0.00,0,1,61,1,2329,2421,92
leader_crash_restart,0.00,0,1,60,1,2322,2421,99
leader_crash_restart,0.00,0,1,62,1,2399,2421,22
leader_crash_restart,0.00,0,1,64,1,2506,2522,16
leader_crash_restart,0.00,0,1,63,1,2436,2522,86
leader_crash_restart,0.00,0,1,65,1,2514,2522,8
leader_crash_restart,0.00,0,1,67,1,2537,2621,84
leader_crash_restart,0.00,0,1,66,1,2524,2621,97
leader_crash_restart,0.00,0,1,68,1,2618,2621,3
leader_crash_restart,0.00,0,1,70,1,2708,2722,14
leader_crash_restart,0.00,0,1,69,1,2629,2722,93
leader_crash_restart,0.00,0,1,71,1,2718,2722,4
leader_crash_restart,0.00,0,1,73,1,2739,2822,83
leader_crash_restart,0.00,0,1,72,1,2729,2822,93
leader_crash_restart,0.00,0,1,74,1,2810,2822,12
leader_crash_restart,0.00,0,1,76,1,2913,2985,72
leader_crash_restart,0.00,0,1,75,1,2841,2985,144
leader_crash_restart,0.00,0,1,77,1,2931,2985,54
leader_crash_restart,0.00,0,1,79,1,3027,3077,50
leader_crash_restart,0.00,0,1,78,1,2997,3077,80
leader_crash_restart,0.00,0,1,80,1,3027,3077,50
leader_crash_restart,0.00,0,1,82,1,3110,3131,21
leader_crash_restart,0.00,0,1,81,1,3078,3131,53
leader_crash_restart,0.00,0,1,83,1,3113,3131,18
leader_crash_restart,0.00,0,1,85,1,3144,3177,33
leader_crash_restart,0.00,0,1,84,1,3141,3178,37
leader_crash_restart,0.00,0,1,86,1,3159,3178,19
leader_crash_restart,0.00,0,1,88,1,3222,3231,9
leader_crash_restart,0.00,0,1,87,1,3190,3231,41
leader_crash_restart,0.00,0,1,89,1,3225,3231,6
leader_crash_restart,0.00,0,1,90,1,3232,3278,46
leader_crash_restart,0.00,0,1,91,1,3235,3278,43
leader_crash_restart,0.00,0,1,92,1,3271,3278,7
leader_crash_restart,0.00,0,1,94,1,3315,3332,17
leader_crash_restart,0.00,0,1,93,1,3282,3332,50
leader_crash_restart,0.00,0,1,95,1,3319,3332,13
leader_crash_restart,0.00,0,1,97,1,3351,3379,28
leader_crash_restart,0.00,0,1,96,1,3349,3379,30
leader_crash_restart,0.00,0,1,98,1,3363,3379,16
leader_crash_restart,0.00,0,1,100,1,3384,3431,47
leader_crash_restart,0.00,0,1,99,1,3383,3432,49
leader_crash_restart,0.00,0,1,101,1,3394,3432,38
leader_crash_restart,0.00,0,1,103,1,3466,3479,13
leader_crash_restart,0.00,0,1,102,1,3466,3479,13
leader_crash_restart,0.00,0,1,104,1,3475,3479,4
leader_crash_restart,0.00,0,1,106,1,3496,3531,35
leader_crash_restart,0.00,0,1,105,1,3485,3532,47
leader_crash_restart,0.00,0,1,107,1,3496,3532,36
leader_crash_restart,0.00,0,1,109,1,3578,3578,0
leader_crash_restart,0.00,0,1,108,1,3566,3578,12
leader_crash_restart,0.00,0,1,110,1,3578,3578,0
leader_crash_restart,0.00,0,1,111,1,3588,3632,44
leader_crash_restart,0.00,0,1,112,1,3588,3632,44
leader_crash_restart,0.00,0,1,113,1,3598,3632,34
leader_crash_restart,0.00,0,1,115,1,3669,3679,10
leader_crash_restart,0.00,0,1,114,1,3669,3679,10
leader_crash_restart,0.00,0,1,117,1,3680,3732,52
leader_crash_restart,0.00,0,1,116,1,3679,3732,53
leader_crash_restart,0.00,0,1,118,1,3680,3732,52
leader_crash_restart,0.00,0,1,120,1,3761,3780,19
leader_crash_restart,0.00,0,1,119,1,3760,3780,20
leader_crash_restart,0.00,0,1,121,1,3761,3780,19
leader_crash_restart,0.00,0,1,123,1,3792,3832,40
leader_crash_restart,0.00,0,1,122,1,3791,3833,42
leader_crash_restart,0.00,0,1,124,1,3792,3833,41
leader_crash_restart,0.00,0,1,126,1,3874,3880,6
leader_crash_restart,0.00,0,1,125,1,3873,3881,8
leader_crash_restart,0.00,0,1,127,1,3874,3881,7
leader_crash_restart,0.00,0,1,129,1,3884,3933,49
leader_crash_restart,0.00,0,1,128,1,3883,3933,50
leader_crash_restart,0.00,0,1,130,1,3884,3933,49
leader_crash_restart,0.00,0,1,132,1,3965,3981,16
leader_crash_restart,0.00,0,1,131,1,3964,3981,17
leader_crash_restart,0.00,0,1,133,1,3965,3981,16
leader_crash_restart,0.00,0,1,135,1,3997,4033,36
leader_crash_restart,0.00,0,1,134,1,3995,4034,39
leader_crash_restart,0.00,0,1,136,1,3997,4034,37
leader_crash_restart,0.00,0,1,138,1,4078,4081,3
leader_crash_restart,0.00,0,1,137,1,4077,4081,4
leader_crash_restart,0.00,0,1,139,1,4078,4081,3
leader_crash_restart,0.00,0,1,141,1,4089,4137,48
leader_crash_restart,0.00,0,1,140,1,4087,4137,50
leader_crash_restart,0.00,0,1,142,1,4089,4137,48
leader_crash_restart,0.00,0,1,144,1,4170,4181,11
leader_crash_restart,0.00,0,1,143,1,4168,4181,13
leader_crash_restart,0.00,0,1,145,1,4170,4182,12
leader_crash_restart,0.00,0,1,147,1,4200,4234,34
leader_crash_restart,0.00,0,1,146,1,4199,4235,36
leader_crash_restart,0.00,0,1,148,1,4200,4235,35
leader_crash_restart,0.00,0,1,150,1,4281,4282,1
leader_crash_restart,0.00,0,1,149,1,4280,4282,2
leader_crash_restart,0.00,0,1,151,1,4281,4282,1
leader_crash_restart,0.00,0,1,153,1,4291,4334,43
leader_crash_restart,0.00,0,1,152,1,4291,4335,44
leader_crash_restart,0.00,0,1,154,1,4291,4335,44
leader_crash_restart,0.00,0,1,155,1,4371,4382,11
leader_crash_restart,0.00,0,1,156,1,4372,4382,10
leader_crash_restart,0.00,0,1,157,1,4372,4382,10
leader_crash_restart,0.00,0,1,159,1,4403,4436,33
leader_crash_restart,0.00,0,1,158,1,4402,4436,34
leader_crash_restart,0.00,0,1,160,1,4403,4436,33
leader_crash_restart,0.00,0,1,162,1,4484,4535,51
leader_crash_restart,0.00,0,1,161,1,4483,4536,53
leader_crash_restart,0.00,0,1,163,1,4484,4536,52
leader_crash_restart,0.00,0,1,164,1,4564,4583,19
leader_crash_restart,0.00,0,1,165,1,4565,4584,19
leader_crash_restart,0.00,0,1,166,1,4565,4584,19
leader_crash_restart,0.00,0,1,168,1,4596,4636,40
leader_crash_restart,0.00,0,1,167,1,4595,4637,42
leader_crash_restart,0.00,0,1,169,1,4596,4637,41
leader_crash_restart,0.00,0,1,171,1,4677,4684,7
leader_crash_restart,0.00,0,1,170,1,4676,4684,8
leader_crash_restart,0.00,0,1,172,1,4677,4684,7
leader_crash_restart,0.00,0,1,174,1,4687,4736,49
leader_crash_restart,0.00,0,1,173,1,4687,4737,50
leader_crash_restart,0.00,0,1,175,1,4687,4737,50
leader_crash_restart,0.00,0,1,177,1,4769,4784,15
leader_crash_restart,0.00,0,1,176,1,4768,4784,16
leader_crash_restart,0.00,0,1,178,1,4769,4784,15
leader_crash_restart,0.00,0,1,180,1,4800,4837,37
leader_crash_restart,0.00,0,1,179,1,4799,4837,38
leader_crash_restart,0.00,0,1,181,1,4800,4837,37
leader_crash_restart,0.00,0,1,183,1,4911,8477,3566
leader_crash_restart,0.00,0,1,182,1,4900,8477,3577
leader_crash_restart,0.00,0,1,185,1,5284,8477,3193
leader_crash_restart,0.00,0,1,184,1,4911,8477,3566
leader_crash_restart,0.00,0,1,187,1,5293,8477,3184
leader_crash_restart,0.00,0,1,186,1,5293,8478,3185
leader_crash_restart,0.00,0,1,189,1,5675,8478,2803
leader_crash_restart,0.00,0,1,188,1,5666,8478,2812
leader_crash_restart,0.00,0,1,191,1,6048,8478,2430
leader_crash_restart,0.00,0,1,190,1,5675,8478,2803
leader_crash_restart,0.00,0,1,193,1,6056,8478,2422
leader_crash_restart,0.00,0,1,192,1,6056,8478,2422
leader_crash_restart,0.00,0,1,195,1,6438,8478,2040
leader_crash_restart,0.00,0,1,194,1,6431,8478,2047
leader_crash_restart,0.00,0,1,197,1,6820,8478,1658
leader_crash_restart,0.00,0,1,196,1,6438,8478,2040
leader_crash_restart,0.00,0,1,199,1,6821,8478,1657
leader_crash_restart,0.00,0,1,198,1,6821,8478,1657
leader_crash_restart,0.00,0,1,201,1,7203,8478,1275
leader_crash_restart,0.00,0,1,200,1,7202,8478,1276
leader_crash_restart,0.00,0,1,203,1,7587,8478,891
leader_crash_restart,0.00,0,1,202,1,7203,8478,1275
leader_crash_restart,0.00,0,1,205,1,7587,8478,891
leader_crash_restart,0.00,0,1,204,1,7587,8478,891
leader_crash_restart,0.00,0,1,207,1,7970,8478,508
leader_crash_restart,0.00,0,1,206,1,7970,8478,508
leader_crash_restart,0.00,0,1,209,1,8363,8478,115
leader_crash_restart,0.00,0,1,208,1,7970,8478,508
leader_crash_restart,0.00,0,1,211,1,8366,8478,112
leader_crash_restart,0.00,0,1,210,1,8363,8478,115
leader_crash_restart,0.00,0,1,212,1,8546,8564,18
leader_crash_restart,0.00,0,1,213,1,8546,8564,18
leader_crash_restart,0.00,0,1,214,1,8549,8564,15
leader_crash_restart,0.00,0,1,216,1,8577,8663,86
leader_crash_restart,0.00,0,1,215,1,8577,8665,88
leader_crash_restart,0.00,0,1,217,1,8580,8665,85
leader_crash_restart,0.00,0,1,219,1,8759,8764,5
leader_crash_restart,0.00,0,1,218,1,8759,8765,6
leader_crash_restart,0.00,0,1,220,1,8762,8765,3
leader_crash_restart,0.00,0,1,222,1,8769,8865,96
leader_crash_restart,0.00,0,1,221,1,8769,8865,96
leader_crash_restart,0.00,0,1,223,1,8772,8865,93
leader_crash_restart,0.00,0,1,225,1,8951,8966,15
leader_crash_restart,0.00,0,1,224,1,8951,8966,15
leader_crash_restart,0.00,0,1,226,1,8954,8966,12
leader_crash_restart,0.00,0,1,228,1,8982,9065,83
leader_crash_restart,0.00,0,1,227,1,8982,9066,84
leader_crash_restart,0.00,0,1,229,1,8984,9066,82
leader_crash_restart,0.00,0,1,278,29,1357,1405,48
leader_crash_restart,0.00,0,1,2,2,477,512,35
leader_crash_restart,0.00,0,1,1,2,455,512,57
leader_crash_restart,0.00,0,1,3,2,483,512,29
leader_crash_restart,0.00,0,1,4,2,514,525,11
leader_crash_restart,0.00,0,1,6,2,544,612,68
leader_crash_restart,0.00,0,1,5,2,536,612,76
leader_crash_restart,0.00,0,1,7,2,558,612,54
leader_crash_restart,0.00,0,1,8,2,617,642,25
leader_crash_restart,0.00,0,1,10,2,639,716,77
leader_crash_restart,0.00,0,1,9,2,625,716,91
leader_crash_restart,0.00,0,1,11,2,648,716,68
leader_crash_restart,0.00,0,1,13,2,729,822,93
leader_crash_restart,0.00,0,1,12,2,721,822,101
leader_crash_restart,0.00,0,1,14,2,806,829,23
leader_crash_restart,0.00,0,1,16,2,902,928,26
leader_crash_restart,0.00,0,1,15,2,837,928,91
leader_crash_restart,0.00,0,1,17,2,911,928,17
leader_crash_restart,0.00,0,1,19,2,941,1014,73
leader_crash_restart,0.00,0,1,18,2,933,1014,81
leader_crash_restart,0.00,0,1,21,2,1019,1032,13
leader_crash_restart,0.00,0,1,20,2,1015,1032,17
leader_crash_restart,0.00,0,1,23,2,1045,1120,75
leader_crash_restart,0.00,0,1,22,2,1022,1120,98
leader_crash_restart,0.00,0,1,24,2,1050,1120,70
leader_crash_restart,0.00,0,1,26,2,1131,1221,90
leader_crash_restart,0.00,0,1,25,2,1126,1221,95
leader_crash_restart,0.00,0,1,27,2,1203,1221,18
leader_crash_restart,0.00,0,1,28,2,1234,1317,83
leader_crash_restart,0.00,0,1,30,2,1312,1339,27
leader_crash_restart,0.00,0,1,29,2,1308,1339,31
leader_crash_restart,0.00,0,1,32,2,1389,1414,25
leader_crash_restart,0.00,0,1,31,2,1343,1414,71
leader_crash_restart,0.00,0,1,33,5,1815,1933,118
leader_crash_restart,0.00,0,1,34,5,1822,1933,111
leader_crash_restart,0.00,0,1,36,5,1997,2035,38
leader_crash_restart,0.00,0,1,35,5,1917,2035,118
leader_crash_restart,0.00,0,1,37,5,2003,2036,33
leader_crash_restart,0.00,0,1,39,5,2084,2134,50
leader_crash_restart,0.00,0,1,38,5,2078,2134,56
leader_crash_restart,0.00,0,1,40,5,2098,2134,36
leader_crash_restart,0.00,0,1,42,5,2165,2218,53
leader_crash_restart,0.00,0,1,41,5,2159,2219,60
leader_crash_restart,0.00,0,1,43,5,2179,2219,40
leader_crash_restart,0.00,0,1,45,5,2246,2316,70
leader_crash_restart,0.00,0,1,44,5,2240,2316,76
leader_crash_restart,0.00,0,1,46,5,2260,2316,56
leader_crash_restart,0.00,0,1,48,5,2327,2416,89
leader_crash_restart,0.00,0,1,47,5,2320,2416,96
leader_crash_restart,0.00,0,1,49,5,2341,2416,75
leader_crash_restart,0.00,0,1,51,5,2502,2531,29
leader_crash_restart,0.00,0,1,50,5,2422,2531,109
leader_crash_restart,0.00,0,1,52,5,2509,2531,22
leader_crash_restart,0.00,0,1,53,5,2533,2624,91
leader_crash_restart,0.00,0,1,54,5,2540,2624,84
leader_crash_restart,0.00,0,1,55,5,2604,2624,20
leader_crash_restart,0.00,0,1,56,5,2635,2722,87
leader_crash_restart,0.00,0,1,58,5,2721,2825,104
leader_crash_restart,0.00,0,1,57,5,2715,2825,110
leader_crash_restart,0.00,0,1,60,8,3181,3237,56
leader_crash_restart,0.00,0,1,59,8,3136,3237,101
leader_crash_restart,0.00,0,1,61,8,3195,3237,42
leader_crash_restart,0.00,0,1,63,8,3276,3338,62
leader_crash_restart,0.00,0,1,62,8,3263,3338,75
leader_crash_restart,0.00,0,1,64,8,3318,3343,25
leader_crash_restart,0.00,0,1,66,8,3349,3420,71
leader_crash_restart,0.00,0,1,65,8,3344,3421,77
leader_crash_restart,0.00,0,1,67,8,3358,3421,63
leader_crash_restart,0.00,0,1,69,8,3430,3451,21
leader_crash_restart,0.00,0,1,68,8,3425,3451,26
leader_crash_restart,0.00,0,1,71,8,3455,3532,77
leader_crash_restart,0.00,0,1,70,8,3439,3532,93
leader_crash_restart,0.00,0,1,72,8,3460,3532,72
leader_crash_restart,0.00,0,1,73,8,3536,3547,11
leader_crash_restart,0.00,0,1,75,8,3567,3636,69
leader_crash_restart,0.00,0,1,74,8,3541,3636,95
leader_crash_restart,0.00,0,1,76,8,3620,3655,35
leader_crash_restart,0.00,0,1,78,8,3701,3727,26
leader_crash_restart,0.00,0,1,77,8,3648,3727,79
leader_crash_restart,0.00,0,1,80,8,3728,3761,33
leader_crash_restart,0.00,0,1,79,8,3723,3761,38
leader_crash_restart,0.00,0,1,81,8,3732,3761,29
leader_crash_restart,0.00,0,1,83,8,3804,3830,26
leader_crash_restart,0.00,0,1,82,8,3762,3831,69
leader_crash_restart,0.00,0,1,84,8,3809,3831,22
leader_crash_restart,0.00,0,1,85,8,3834,3848,14
leader_crash_restart,0.00,0,1,87,8,3844,3927,83
leader_crash_restart,0.00,0,1,86,8,3840,3928,88
leader_crash_restart,0.00,0,1,88,8,3865,3928,63
leader_crash_restart,0.00,0,1,89,8,3945,4029,84
leader_crash_restart,0.00,0,1,91,8,4025,4060,35
leader_crash_restart,0.00,0,1,90,8,4022,4060,38
leader_crash_restart,0.00,0,1,93,8,4107,4126,19
leader_crash_restart,0.00,0,1,92,8,4103,4126,23
leader_crash_restart,0.00,0,1,95,8,4133,4156,23
leader_crash_restart,0.00,0,1,94,8,4127,4156,29
leader_crash_restart,0.00,0,1,96,8,4138,4156,18
leader_crash_restart,0.00,0,1,98,8,4164,4327,163
leader_crash_restart,0.00,0,1,97,8,4157,4327,170
leader_crash_restart,0.00,0,1,99,8,4169,4327,158
leader_crash_restart,0.00,0,1,100,8,4338,4360,22
leader_crash_restart,0.00,0,1,102,8,4350,4449,99
leader_crash_restart,0.00,0,1,101,8,4345,4449,104
leader_crash_restart,0.00,0,1,103,8,4368,4449,81
leader_crash_restart,0.00,0,1,104,8,4449,4529,80
leader_crash_restart,0.00,0,1,106,8,4530,4562,32
leader_crash_restart,0.00,0,1,105,8,4527,4562,35
leader_crash_restart,0.00,0,1,107,8,4531,4562,31
leader_crash_restart,0.00,0,1,109,8,4612,4652,40
leader_crash_restart,0.00,0,1,108,8,4608,4652,44
leader_crash_restart,0.00,0,1,110,8,4612,4652,40
leader_crash_restart,0.00,0,1,112,8,4693,4850,157
leader_crash_restart,0.00,0,1,111,8,4689,4850,161
leader_crash_restart,0.00,0,1,113,8,4693,4850,157
leader_crash_restart,0.00,0,1,115,8,4874,4939,65
leader_crash_restart,0.00,0,1,114,8,4870,4939,69
leader_crash_restart,0.00,0,1,116,8,4874,4939,65
leader_crash_restart,0.00,0,1,118,8,4956,5032,76
leader_crash_restart,0.00,0,1,117,8,4952,5033,81
leader_crash_restart,0.00,0,1,119,8,4956,5033,77
leader_crash_restart,0.00,0,1,121,8,5037,5067,30
leader_crash_restart,0.00,0,1,120,8,5034,5067,33
leader_crash_restart,0.00,0,1,122,8,5037,5068,31
leader_crash_restart,0.00,0,1,124,8,5068,5163,95
leader_crash_restart,0.00,0,1,123,8,5068,5163,95
leader_crash_restart,0.00,0,1,125,8,5114,5163,49
leader_crash_restart,0.00,0,1,126,8,5195,5236,41
leader_crash_restart,0.00,0,1,128,8,5250,5343,93
leader_crash_restart,0.00,0,1,127,8,5250,5344,94
leader_crash_restart,0.00,0,1,129,8,5276,5344,68
leader_crash_restart,0.00,0,1,130,8,5357,5426,69
leader_crash_restart,0.00,0,1,132,8,5431,5524,93
leader_crash_restart,0.00,0,1,131,8,5431,5525,94
leader_crash_restart,0.00,0,1,133,8,5439,5525,86
leader_crash_restart,0.00,0,1,143,19,9431,10161,730
leader_crash_restart,0.00,0,1,145,19,9439,10161,722
leader_crash_restart,0.00,0,1,147,19,9813,10161,348
leader_crash_restart,0.00,0,1,146,19,9813,10161,348
leader_crash_restart,0.00,0,1,144,19,9431,10161,730
leader_crash_restart,0.00,0,1,148,19,9820,10161,341
leader_crash_restart,0.00,0,1,150,19,10195,10277,82
leader_crash_restart,0.00,0,1,149,19,10195,10277,82
leader_crash_restart,0.00,0,1,151,19,10203,10277,74
leader_crash_restart,0.00,0,1,152,19,10284,10353,69
leader_crash_restart,0.00,0,1,154,19,10376,10459,83
leader_crash_restart,0.00,0,1,153,19,10365,10459,94
leader_crash_restart,0.00,0,1,155,19,10376,10459,83
leader_crash_restart,0.00,0,1,156,19,10546,10561,15
leader_crash_restart,0.00,0,1,158,19,10558,10654,96
leader_crash_restart,0.00,0,1,157,19,10558,10655,97
leader_crash_restart,0.00,0,1,159,19,10577,10655,78
leader_crash_restart,0.00,0,1,160,19,10658,10754,96
leader_crash_restart,0.00,0,1,162,19,10739,10763,24
leader_crash_restart,0.00,0,1,161,19,10739,10763,24
leader_crash_restart,0.00,0,1,163,19,10770,10867,97
leader_crash_restart,0.00,0,1,164,19,10770,10868,98
leader_crash_restart,0.00,0,1,165,19,10840,10868,28
leader_crash_restart,0.00,0,1,166,19,10871,10975,104
leader_crash_restart,0.00,0,1,168,19,10951,10978,27
leader_crash_restart,0.00,0,1,167,19,10951,10978,27
leader_crash_restart,0.00,0,1,170,19,10982,11058,76
leader_crash_restart,0.00,0,1,169,19,10982,11058,76
leader_crash_restart,0.00,0,1,172,19,11063,11167,104
leader_crash_restart,0.00,0,1,171,19,11053,11167,114
leader_crash_restart,0.00,0,1,173,19,11063,11167,104
leader_crash_restart,0.00,0,1,174,25,12278,13974,1696
leader_crash_restart,0.00,0,1,176,28,12692,13974,1282
leader_crash_restart,0.00,0,1,175,25,12309,13974,1665
leader_crash_restart,0.00,0,1,185,28,13838,13974,136
leader_crash_restart,0.00,0,1,186,28,13864,13974,110
leader_crash_restart,0.00,0,1,177,28,12719,13974,1255
leader_crash_restart,0.00,0,1,180,28,13101,13974,873
leader_crash_restart,0.00,0,1,179,28,13074,13974,900
leader_crash_restart,0.00,0,1,182,28,13456,13974,518
leader_crash_restart,0.00,0,1,181,28,13121,13974,853
leader_crash_restart,0.00,0,1,184,28,13503,13974,471
leader_crash_restart,0.00,0,1,183,28,13482,13974,492
leader_crash_restart,0.00,0,1,178,28,12740,13974,1234
leader_crash_restart,0.00,0,1,187,28,13885,13988,103
leader_crash_restart,0.00,0,1,189,28,14045,14078,33
leader_crash_restart,0.00,0,1,188,28,14019,14078,59
leader_crash_restart,0.00,0,1,190,28,14066,14078,12
leader_crash_restart,0.00,0,1,192,28,14099,14269,170
leader_crash_restart,0.00,0,1,191,28,14097,14269,172
leader_crash_restart,0.00,0,1,193,28,14126,14269,143
leader_crash_restart,0.00,0,1,195,28,14281,14369,88
leader_crash_restart,0.00,0,1,194,28,14279,14369,90
leader_crash_restart,0.00,0,1,196,28,14308,14369,61
leader_crash_restart,0.00,0,1,197,28,14389,14476,87
leader_crash_restart,0.00,0,1,199,28,14463,14575,112
leader_crash_restart,0.00,0,1,198,28,14460,14575,115
leader_crash_restart,0.00,0,1,200,28,14570,14596,26
leader_crash_restart,0.00,0,1,202,28,14642,14670,28
leader_crash_restart,0.00,0,1,201,28,14602,14671,69
leader_crash_restart,0.00,0,1,203,28,14644,14671,27
leader_crash_restart,0.00,0,1,205,28,14674,14777,103
leader_crash_restart,0.00,0,1,204,28,14673,14777,104
leader_crash_restart,0.00,0,1,206,28,14683,14777,94
leader_crash_restart,0.00,0,1,208,28,14856,14970,114
leader_crash_restart,0.00,0,1,207,28,14855,14970,115
leader_crash_restart,0.00,0,1,209,28,14864,14970,106
leader_crash_restart,0.00,0,1,210,28,16045,16061,16
leader_crash_restart,0.00,0,1,211,28,18049,18068,19
leader_crash_restart,0.00,0,1,212,28,20070,20074,4
leader_crash_restart,0.00,0,1,1,1,303,401,98
leader_crash_restart,0.00,0,1,2,2,302,401,99
leader_crash_restart,0.00,0,1,3,3,304,403,99
leader_crash_restart,0.00,0,1,4,4,2456,2512,56
leader_crash_restart,0.00,0,1,5,4,3320,3416,96
leader_crash_restart,0.00,0,1,6,4,3525,3616,91
leader_crash_restart,0.00,0,1,1,1,304,401,97
leader_crash_restart,0.00,0,1,2,1,1024,1103,79
leader_crash_restart,0.00,0,1,3,7,504,603,99
leader_crash_restart,0.00,0,1,4,7,2722,2810,88
leader_crash_restart,0.00,0,1,5,7,3358,3411,53
leader_crash_restart,0.00,0,1,6,13,352,402,50
leader_crash_restart,0.00,0,1,7,13,520,604,84
leader_crash_restart,0.00,0,1,8,13,1238,1307,69
leader_crash_restart,0.00,0,1,9,18,302,401,99
leader_crash_restart,0.00,0,1,10,18,506,601,95
leader_crash_restart,0.00,0,1,11,18,1258,1304,46
leader_crash_restart,0.00,0,1,12,25,402,502,100
leader_crash_restart,0.00,0,1,13,25,2608,2610,2
leader_crash_restart,0.00,0,1,14,25,3096,3112,16
leader_crash_restart,0.00,0,1,15,30,302,401,99
leader_crash_restart,0.00,0,1,16,30,506,603,97
leader_crash_restart,0.00,0,1,1,1,403,501,98
leader_crash_restart,0.00,0,1,2,1,1147,1204,57
leader_crash_restart,0.00,0,1,3,3,503,602,99
leader_crash_restart,0.00,0,1,4,3,708,803,95
leader_crash_restart,0.00,0,1,1,1,410,502,92
leader_crash_restart,0.00,0,1,10,28,539,702,163
leader_crash_restart,0.00,0,1,14,46,579,603,24
leader_crash_restart,0.00,0,1,21,99,696,810,114
leader_crash_restart,0.00,0,1,22,107,700,1003,303
leader_crash_restart,0.00,0,1,23,109,3354,3414,60
leader_crash_restart,0.00,0,1,25,115,821,904,83
leader_crash_restart,0.00,0,1,2,1,354,414,60
leader_crash_restart,0.00,0,1,1,1,354,414,60
leader_crash_restart,0.00,0,1,4,1,354,414,60
leader_crash_restart,0.00,0,1,3,1,354,414,60
leader_crash_restart,0.00,0,1,5,1,354,414,60
leader_crash_restart,0.00,0,1,7,1,417,520,103
leader_crash_restart,0.00,0,1,6,1,417,520,103
leader_crash_restart,0.00,0,1,9,1,417,520,103
leader_crash_restart,0.00,0,1,8,1,417,521,104
leader_crash_restart,0.00,0,1,10,1,417,521,104
leader_crash_restart,0.00,0,1,12,1,539,608,69
leader_crash_restart,0.00,0,1,13,1,539,608,69
leader_crash_restart,0.00,0,1,11,1,539,608,69
leader_crash_restart,0.00,0,1,14,1,539,608,69
leader_crash_restart,0.00,0,1,15,1,539,608,69
leader_crash_restart,0.00,0,1,17,1,621,718,97
leader_crash_restart,0.00,0,1,16,1,621,718,97
leader_crash_restart,0.00,0,1,19,1,621,718,97
leader_crash_restart,0.00,0,1,18,1,621,718,97
leader_crash_restart,0.00,0,1,20,1,621,718,97
leader_crash_restart,0.00,0,1,22,1,723,815,92
leader_crash_restart,0.00,0,1,21,1,723,815,92
leader_crash_restart,0.00,0,1,24,1,723,815,92
leader_crash_restart,0.00,0,1,23,1,723,815,92
leader_crash_restart,0.00,0,1,25,1,723,816,93
leader_crash_restart,0.00,0,1,27,1,824,913,89
leader_crash_restart,0.00,0,1,26,1,824,913,89
leader_crash_restart,0.00,0,1,29,1,824,913,89
leader_crash_restart,0.00,0,1,28,1,824,913,89
leader_crash_restart,0.00,0,1,30,1,824,913,89
leader_crash_restart,0.00,0,1,32,1,925,1008,83
leader_crash_restart,0.00,0,1,31,1,925,1008,83
leader_crash_restart,0.00,0,1,34,1,925,1008,83
leader_crash_restart,0.00,0,1,33,1,925,1008,83
leader_crash_restart,0.00,0,1,35,1,925,1008,83
leader_crash_restart,0.00,0,1,37,1,1026,1114,88
leader_crash_restart,0.00,0,1,36,1,1026,1115,89
leader_crash_restart,0.00,0,1,39,1,1026,1115,89
leader_crash_restart,0.00,0,1,38,1,1026,1115,89
leader_crash_restart,0.00,0,1,40,1,1026,1115,89
leader_crash_restart,0.00,0,1,42,1,1128,1219,91
leader_crash_restart,0.00,0,1,41,1,1128,1219,91
leader_crash_restart,0.00,0,1,44,1,1128,1219,91
leader_crash_restart,0.00,0,1,43,1,1128,1219,91
leader_crash_restart,0.00,0,1,45,1,1128,1219,91
leader_crash_restart,0.00,0,1,47,1,1230,1310,80
leader_crash_restart,0.00,0,1,46,1,1230,1310,80
leader_crash_restart,0.00,0,1,49,1,1230,1311,81
leader_crash_restart,0.00,0,1,48,1,1230,1311,81
leader_crash_restart,0.00,0,1,50,1,1230,1311,81
leader_crash_restart,0.00,0,1,52,1,1311,1331,20
leader_crash_restart,0.00,0,1,51,1,1311,1331,20
leader_crash_restart,0.00,0,1,54,1,1311,1331,20
leader_crash_restart,0.00,0,1,53,1,1311,1331,20
leader_crash_restart,0.00,0,1,55,1,1311,1331,20
leader_crash_restart,0.00,0,1,57,1,1351,1433,82
leader_crash_restart,0.00,0,1,56,1,1351,1433,82
leader_crash_restart,0.00,0,1,58,1,1351,1433,82
leader_crash_restart,0.00,0,1,60,1,1351,1433,82
leader_crash_restart,0.00,0,1,59,1,1351,1433,82
leader_crash_restart,0.00,0,1,62,1,1453,1524,71
leader_crash_restart,0.00,0,1,61,1,1453,1524,71
leader_crash_restart,0.00,0,1,64,1,1453,1524,71
leader_crash_restart,0.00,0,1,63,1,1453,1524,71
leader_crash_restart,0.00,0,1,65,1,1453,1524,71
leader_crash_restart,0.00,0,1,67,1,1535,1627,92
leader_crash_restart,0.00,0,1,66,1,1535,1627,92
leader_crash_restart,0.00,0,1,69,1,1535,1627,92
leader_crash_restart,0.00,0,1,68,1,1535,1627,92
leader_crash_restart,0.00,0,1,70,1,1535,1627,92
leader_crash_restart,0.00,0,1,72,1,1637,1723,86
leader_crash_restart,0.00,0,1,71,1,1637,1723,86
leader_crash_restart,0.00,0,1,74,1,1637,1723,86
leader_crash_restart,0.00,0,1,73,1,1637,1723,86
leader_crash_restart,0.00,0,1,75,1,1637,1723,86
leader_crash_restart,0.00,0,1,77,1,1738,1820,82
leader_crash_restart,0.00,0,1,76,1,1738,1820,82
leader_crash_restart,0.00,0,1,79,1,1738,1820,82
leader_crash_restart,0.00,0,1,78,1,1738,1820,82
leader_crash_restart,0.00,0,1,80,1,1738,1820,82
leader_crash_restart,0.00,0,1,82,1,1839,1913,74
leader_crash_restart,0.00,0,1,81,1,1839,1914,75
leader_crash_restart,0.00,0,1,84,1,1839,1914,75
leader_crash_restart,0.00,0,1,83,1,1839,1914,75
leader_crash_restart,0.00,0,1,85,1,1840,1914,74
leader_crash_restart,0.00,0,1,87,1,1921,2020,99
leader_crash_restart,0.00,0,1,86,1,1921,2020,99
leader_crash_restart,0.00,0,1,89,1,1921,2020,99
leader_crash_restart,0.00,0,1,88,1,1921,2020,99
leader_crash_restart,0.00,0,1,90,1,1921,2020,99
leader_crash_restart,0.00,0,1,92,1,2022,2118,96
leader_crash_restart,0.00,0,1,91,1,2022,2118,96
leader_crash_restart,0.00,0,1,94,1,2022,2118,96
leader_crash_restart,0.00,0,1,93,1,2022,2118,96
leader_crash_restart,0.00,0,1,95,1,2022,2118,96
leader_crash_restart,0.00,0,1,97,1,2123,2219,96
leader_crash_restart,0.00,0,1,96,1,2123,2219,96
leader_crash_restart,0.00,0,1,99,1,2123,2219,96
leader_crash_restart,0.00,0,1,98,1,2123,2219,96
leader_crash_restart,0.00,0,1,100,1,2123,2219,96
leader_crash_restart,0.00,0,1,102,1,2225,2330,105
leader_crash_restart,0.00,0,1,101,1,2225,2330,105
leader_crash_restart,0.00,0,1,104,1,2225,2330,105
leader_crash_restart,0.00,0,1,103,1,2225,2330,105
leader_crash_restart,0.00,0,1,105,1,2225,2330,105
leader_crash_restart,0.00,0,1,107,1,2347,2423,76
leader_crash_restart,0.00,0,1,106,1,2347,2423,76
leader_crash_restart,0.00,0,1,109,1,2347,2423,76
leader_crash_restart,0.00,0,1,108,1,2347,2423,76
leader_crash_restart,0.00,0,1,110,1,2347,2423,76
leader_crash_restart,0.00,0,1,112,1,2429,2516,87
leader_crash_restart,0.00,0,1,111,1,2429,2516,87
leader_crash_restart,0.00,0,1,114,1,2429,2516,87
leader_crash_restart,0.00,0,1,113,1,2429,2516,87
leader_crash_restart,0.00,0,1,115,1,2429,2516,87
leader_crash_restart,0.00,0,1,117,1,2530,2622,92
leader_crash_restart,0.00,0,1,116,1,2530,2623,93
leader_crash_restart,0.00,0,1,119,1,2530,2623,93
leader_crash_restart,0.00,0,1,118,1,2530,2623,93
leader_crash_restart,0.00,0,1,120,1,2530,2623,93
leader_crash_restart,0.00,0,1,122,1,2631,2729,98
leader_crash_restart,0.00,0,1,121,1,2631,2729,98
leader_crash_restart,0.00,0,1,124,1,2631,2729,98
leader_crash_restart,0.00,0,1,123,1,2631,2729,98
leader_crash_restart,0.00,0,1,125,1,2631,2729,98
leader_crash_restart,0.00,0,1,126,1,2733,2822,89
leader_crash_restart,0.00,0,1,127,1,2733,2823,90
leader_crash_restart,0.00,0,1,129,1,2733,2823,90
leader_crash_restart,0.00,0,1,128,1,2733,2823,90
leader_crash_restart,0.00,0,1,130,1,2733,2823,90
leader_crash_restart,0.00,0,1,132,1,2834,2917,83
leader_crash_restart,0.00,0,1,131,1,2834,2918,84
leader_crash_restart,0.00,0,1,134,1,2834,2918,84
leader_crash_restart,0.00,0,1,133,1,2834,2918,84
leader_crash_restart,0.00,0,1,135,1,2834,2918,84
leader_crash_restart,0.00,0,1,137,1,2936,3024,88
leader_crash_restart,0.00,0,1,136,1,2936,3024,88
leader_crash_restart,0.00,0,1,139,1,2936,3024,88
leader_crash_restart,0.00,0,1,138,1,2936,3024,88
leader_crash_restart,0.00,0,1,140,1,2936,3024,88
leader_crash_restart,0.00,0,1,142,1,3037,3126,89
leader_crash_restart,0.00,0,1,141,1,3037,3127,90
leader_crash_restart,0.00,0,1,144,1,3038,3127,89
leader_crash_restart,0.00,0,1,143,1,3037,3127,90
leader_crash_restart,0.00,0,1,145,1,3038,3127,89
leader_crash_restart,0.00,0,1,147,1,3139,3223,84
leader_crash_restart,0.00,0,1,146,1,3139,3223,84
leader_crash_restart,0.00,0,1,149,1,3139,3223,84
leader_crash_restart,0.00,0,1,148,1,3139,3223,84
leader_crash_restart,0.00,0,1,150,1,3139,3223,84
leader_crash_restart,0.00,0,1,152,1,3240,3325,85
leader_crash_restart,0.00,0,1,151,1,3240,3325,85
leader_crash_restart,0.00,0,1,154,1,3241,3325,84
leader_crash_restart,0.00,0,1,153,1,3240,3325,85
leader_crash_restart,0.00,0,1,155,1,3241,3325,84
leader_crash_restart,0.00,0,1,157,1,3342,3426,84
leader_crash_restart,0.00,0,1,156,1,3342,3430,88
leader_crash_restart,0.00,0,1,159,1,3342,3430,88
leader_crash_restart,0.00,0,1,158,1,3342,3430,88
leader_crash_restart,0.00,0,1,160,1,3342,3430,88
leader_crash_restart,0.00,0,1,162,1,3444,3527,83
leader_crash_restart,0.00,0,1,161,1,3444,3527,83
leader_crash_restart,0.00,0,1,164,1,3444,3527,83
leader_crash_restart,0.00,0,1,163,1,3444,3527,83
leader_crash_restart,0.00,0,1,165,1,3444,3527,83
leader_crash_restart,0.00,0,1,167,1,3545,3623,78
leader_crash_restart,0.00,0,1,166,1,3545,3623,78
leader_crash_restart,0.00,0,1,169,1,3545,3623,78
leader_crash_restart,0.00,0,1,168,1,3545,3623,78
leader_crash_restart,0.00,0,1,170,1,3545,3623,78
leader_crash_restart,0.00,0,1,172,1,3627,3722,95
leader_crash_restart,0.00,0,1,171,1,3627,3723,96
leader_crash_restart,0.00,0,1,174,1,3627,3723,96
leader_crash_restart,0.00,0,1,173,1,3627,3723,96
leader_crash_restart,0.00,0,1,175,1,3627,3723,96
leader_crash_restart,0.00,0,1,177,1,3728,3821,93
leader_crash_restart,0.00,0,1,176,1,3728,3821,93
leader_crash_restart,0.00,0,1,179,1,3728,3821,93
leader_crash_restart,0.00,0,1,180,1,3728,3821,93
leader_crash_restart,0.00,0,1,178,1,3728,3821,93
leader_crash_restart,0.00,0,1,182,1,3829,3925,96
leader_crash_restart,0.00,0,1,181,1,3829,3925,96
leader_crash_restart,0.00,0,1,184,1,3830,3925,95
leader_crash_restart,0.00,0,1,183,1,3830,3925,95
leader_crash_restart,0.00,0,1,185,1,3830,3925,95
leader_crash_restart,0.00,0,1,187,1,3931,4019,88
leader_crash_restart,0.00,0,1,186,1,3931,4019,88
leader_crash_restart,0.00,0,1,189,1,3931,4019,88
leader_crash_restart,0.00,0,1,188,1,3931,4019,88
leader_crash_restart,0.00,0,1,190,1,3931,4019,88
leader_crash_restart,0.00,0,1,192,1,4032,4127,95
leader_crash_restart,0.00,0,1,191,1,4032,4127,95
leader_crash_restart,0.00,0,1,194,1,4033,4127,94
leader_crash_restart,0.00,0,1,193,1,4032,4127,95
leader_crash_restart,0.00,0,1,195,1,4033,4127,94
leader_crash_restart,0.00,0,1,197,1,4135,4225,90
leader_crash_restart,0.00,0,1,199,1,4135,4225,90
leader_crash_restart,0.00,0,1,198,1,4135,4225,90
leader_crash_restart,0.00,0,1,196,1,4135,4225,90
leader_crash_restart,0.00,0,1,200,1,4135,4225,90
leader_crash_restart,0.00,0,1,202,1,4236,4328,92
leader_crash_restart,0.00,0,1,201,1,4236,4329,93
leader_crash_restart,0.00,0,1,204,1,4237,4329,92
leader_crash_restart,0.00,0,1,203,1,4237,4329,92
leader_crash_restart,0.00,0,1,205,1,4237,4329,92
leader_crash_restart,0.00,0,1,206,1,4338,4431,93
leader_crash_restart,0.00,0,1,207,1,4338,4432,94
leader_crash_restart,0.00,0,1,209,1,4338,4432,94
leader_crash_restart,0.00,0,1,208,1,4338,4432,94
leader_crash_restart,0.00,0,1,210,1,4338,4432,94
leader_crash_restart,0.00,0,1,212,1,4440,4535,95
leader_crash_restart,0.00,0,1,211,1,4440,4536,96
leader_crash_restart,0.00,0,1,214,1,4440,4536,96
leader_crash_restart,0.00,0,1,213,1,4440,4536,96
leader_crash_restart,0.00,0,1,215,1,4440,4536,96
leader_crash_restart,0.00,0,1,217,1,4541,4630,89
leader_crash_restart,0.00,0,1,216,1,4541,4630,89
leader_crash_restart,0.00,0,1,219,1,4541,4630,89
leader_crash_restart,0.00,0,1,218,1,4541,4630,89
leader_crash_restart,0.00,0,1,220,1,4541,4630,89
leader_crash_restart,0.00,0,1,222,1,4643,4737,94
leader_crash_restart,0.00,0,1,221,1,4643,4737,94
leader_crash_restart,0.00,0,1,224,1,4643,4737,94
leader_crash_restart,0.00,0,1,223,1,4643,4737,94
leader_crash_restart,0.00,0,1,225,1,4644,4737,93
leader_crash_restart,0.00,0,1,227,1,4746,4824,78
leader_crash_restart,0.00,0,1,226,1,4746,4824,78
leader_crash_restart,0.00,0,1,229,1,4747,4824,77
leader_crash_restart,0.00,0,1,228,1,4746,4824,78
leader_crash_restart,0.00,0,1,230,1,4747,4824,77
leader_crash_restart,0.00,0,1,232,1,4828,4923,95
leader_crash_restart,0.00,0,1,233,1,4828,4923,95
leader_crash_restart,0.00,0,1,231,1,4828,4924,96
leader_crash_restart,0.00,0,1,234,1,4828,4924,96
leader_crash_restart,0.00,0,1,235,1,4829,4924,95
leader_crash_restart,0.00,0,1,237,1,4930,5034,104
leader_crash_restart,0.00,0,1,236,1,4930,5035,105
leader_crash_restart,0.00,0,1,239,1,4931,5035,104
leader_crash_restart,0.00,0,1,238,1,4930,5035,105
leader_crash_restart,0.00,0,1,240,1,4931,5035,104
leader_crash_restart,0.00,0,1,242,1,5052,5131,79
leader_crash_restart,0.00,0,1,241,1,5052,5131,79
leader_crash_restart,0.00,0,1,244,1,5052,5131,79
leader_crash_restart,0.00,0,1,243,1,5052,5131,79
leader_crash_restart,0.00,0,1,245,1,5052,5131,79
leader_crash_restart,0.00,0,1,246,1,5133,5221,88
leader_crash_restart,0.00,0,1,1,1,457,512,55
leader_crash_restart,0.00,0,1,3,6,1995,2022,27
leader_crash_restart,0.00,0,1,2,6,1995,2022,27
leader_crash_restart,0.00,0,1,5,6,2009,20882,18873
leader_crash_restart,0.00,0,1,10,6,2041,20882,18841
leader_crash_restart,0.00,0,1,4,6,2006,20882,18876
leader_crash_restart,0.00,0,1,44,6,3393,20882,17489
leader_crash_restart,0.00,0,1,50,6,3424,20882,17458
leader_crash_restart,0.00,0,1,56,6,3460,20882,17422
leader_crash_restart,0.00,0,1,62,6,3624,20882,17258
leader_crash_restart,0.00,0,1,7,6,2026,20882,18856
leader_crash_restart,0.00,0,1,67,6,3654,20882,17228
leader_crash_restart,0.00,0,1,77,6,3698,20882,17184
leader_crash_restart,0.00,0,1,86,6,3739,20882,17143
leader_crash_restart,0.00,0,1,6,6,2021,20882,18861
leader_crash_restart,0.00,0,1,9,6,2034,20882,18848
leader_crash_restart,0.00,0,1,8,6,2030,20882,18852
leader_crash_restart,0.00,0,1,97,6,3808,20882,17074
leader_crash_restart,0.00,0,1,101,6,3824,20882,17058
leader_crash_restart,0.00,0,1,109,6,3979,20882,16903
leader_crash_restart,0.00,0,1,11,6,2043,20882,18839
leader_crash_restart,0.00,0,1,13,6,2049,20882,18833
leader_crash_restart,0.00,0,1,131,17,5316,20882,15566
leader_crash_restart,0.00,0,1,135,17,5340,20882,15542
leader_crash_restart,0.00,0,1,137,17,5355,20882,15527
leader_crash_restart,0.00,0,1,146,17,5434,20882,15448
leader_crash_restart,0.00,0,1,12,6,2043,20882,18839
leader_crash_restart,0.00,0,1,15,6,2486,20882,18396
leader_crash_restart,0.00,0,1,14,6,2052,20882,18830
leader_crash_restart,0.00,0,1,161,17,5534,20882,15348
leader_crash_restart,0.00,0,1,17,6,2500,20882,18382
leader_crash_restart,0.00,0,1,169,17,6604,20883,14279
leader_crash_restart,0.00,0,1,185,17,7069,20883,13814
leader_crash_restart,0.00,0,1,190,17,7905,20883,12978
leader_crash_restart,0.00,0,1,195,17,7933,20883,12950
leader_crash_restart,0.00,0,1,201,17,8693,20883,12190
leader_crash_restart,0.00,0,1,202,17,8694,20883,12189
leader_crash_restart,0.00,0,1,207,17,8877,20883,12006
leader_crash_restart,0.00,0,1,16,6,2498,20883,18385
leader_crash_restart,0.00,0,1,19,6,2517,20883,18366
leader_crash_restart,0.00,0,1,216,17,8934,20883,11949
leader_crash_restart,0.00,0,1,18,6,2512,20883,18371
leader_crash_restart,0.00,0,1,21,6,2533,20883,18350
leader_crash_restart,0.00,0,1,222,17,8970,20883,11913
leader_crash_restart,0.00,0,1,23,6,2549,20883,18334
leader_crash_restart,0.00,0,1,231,17,9327,20883,11556
leader_crash_restart,0.00,0,1,235,17,9814,20883,11069
leader_crash_restart,0.00,0,1,20,6,2526,20883,18357
leader_crash_restart,0.00,0,1,243,17,10234,20883,10649
leader_crash_restart,0.00,0,1,245,17,10237,20883,10646
leader_crash_restart,0.00,0,1,253,17,10478,20883,10405
leader_crash_restart,0.00,0,1,260,17,10529,20883,10354
leader_crash_restart,0.00,0,1,264,17,10560,20883,10323
leader_crash_restart,0.00,0,1,267,17,10945,20883,9938
leader_crash_restart,0.00,0,1,272,17,11057,20883,9826
leader_crash_restart,0.00,0,1,276,17,11068,20883,9815
leader_crash_restart,0.00,0,1,22,6,2544,20883,18339
leader_crash_restart,0.00,0,1,280,17,11393,20883,9490
leader_crash_restart,0.00,0,1,24,6,2557,20883,18326
leader_crash_restart,0.00,0,1,26,6,2572,20883,18311
leader_crash_restart,0.00,0,1,285,17,11731,20883,9152
leader_crash_restart,0.00,0,1,288,17,12056,20883,8827
leader_crash_restart,0.00,0,1,291,17,12079,20883,8804
leader_crash_restart,0.00,0,1,296,17,12124,20883,8759
leader_crash_restart,0.00,0,1,299,17,12147,20883,8736
leader_crash_restart,0.00,0,1,303,17,12336,20883,8547
leader_crash_restart,0.00,0,1,310,17,12380,20883,8503
leader_crash_restart,0.00,0,1,313,17,12400,20883,8483
leader_crash_restart,0.00,0,1,355,17,14325,20883,6558
leader_crash_restart,0.00,0,1,27,6,2574,20883,18309
leader_crash_restart,0.00,0,1,300,17,12148,20883,8735
leader_crash_restart,0.00,0,1,29,6,2583,20883,18300
leader_crash_restart,0.00,0,1,28,6,2579,20883,18304
leader_crash_restart,0.00,0,1,369,17,15395,20883,5488
leader_crash_restart,0.00,0,1,31,6,2592,20883,18291
leader_crash_restart,0.00,0,1,379,17,15473,20883,5410
leader_crash_restart,0.00,0,1,390,17,15593,20883,5290
leader_crash_restart,0.00,0,1,30,6,2590,20883,18293
leader_crash_restart,0.00,0,1,33,6,2845,20883,18038
leader_crash_restart,0.00,0,1,32,6,2845,20883,18038
leader_crash_restart,0.00,0,1,35,6,2866,20883,18017
leader_crash_restart,0.00,0,1,34,6,2855,20883,18028
leader_crash_restart,0.00,0,1,37,6,2877,20883,18006
leader_crash_restart,0.00,0,1,39,6,2883,20883,18000
leader_crash_restart,0.00,0,1,38,6,2881,20883,18002
leader_crash_restart,0.00,0,1,41,6,2888,20883,17995
leader_crash_restart,0.00,0,1,36,6,2873,20883,18010
leader_crash_restart,0.00,0,1,43,6,2905,20883,17978
leader_crash_restart,0.00,0,1,40,6,2883,20883,18000
leader_crash_restart,0.00,0,1,42,6,2900,20883,17983
leader_crash_restart,0.00,0,1,45,6,3397,20883,17486
leader_crash_restart,0.00,0,1,47,6,3409,20883,17474
leader_crash_restart,0.00,0,1,46,6,3399,20883,17484
leader_crash_restart,0.00,0,1,48,6,3411,20883,17472
leader_crash_restart,0.00,0,1,49,6,3421,20883,17462
leader_crash_restart,0.00,0,1,51,6,3425,20883,17458
leader_crash_restart,0.00,0,1,53,6,3443,20883,17440
leader_crash_restart,0.00,0,1,55,6,3449,20884,17435
leader_crash_restart,0.00,0,1,54,6,3445,20884,17439
leader_crash_restart,0.00,0,1,52,6,3435,20884,17449
leader_crash_restart,0.00,0,1,57,6,3599,20884,17285
leader_crash_restart,0.00,0,1,59,6,3612,20884,17272
leader_crash_restart,0.00,0,1,58,6,3609,20884,17275
leader_crash_restart,0.00,0,1,61,6,3623,20884,17261
leader_crash_restart,0.00,0,1,60,6,3615,20884,17269
leader_crash_restart,0.00,0,1,63,6,3634,20884,17250
leader_crash_restart,0.00,0,1,65,6,3646,20884,17238
leader_crash_restart,0.00,0,1,64,6,3644,20884,17240
leader_crash_restart,0.00,0,1,66,6,3653,20884,17231
leader_crash_restart,0.00,0,1,68,6,3658,20884,17226
leader_crash_restart,0.00,0,1,70,6,3663,20884,17221
leader_crash_restart,0.00,0,1,72,6,3671,20884,17213
leader_crash_restart,0.00,0,1,69,6,3661,20884,17223
leader_crash_restart,0.00,0,1,74,6,3685,20884,17199
leader_crash_restart,0.00,0,1,71,6,3666,20884,17218
leader_crash_restart,0.00,0,1,76,6,3695,20884,17189
leader_crash_restart,0.00,0,1,73,6,3683,20884,17201
leader_crash_restart,0.00,0,1,75,6,3686,20884,17198
leader_crash_restart,0.00,0,1,80,6,3711,20884,17173
leader_crash_restart,0.00,0,1,79,6,3699,20884,17185
leader_crash_restart,0.00,0,1,78,6,3698,20884,17186
leader_crash_restart,0.00,0,1,84,6,3734,20884,17150
leader_crash_restart,0.00,0,1,83,6,3725,20884,17159
leader_crash_restart,0.00,0,1,81,6,3712,20884,17172
leader_crash_restart,0.00,0,1,82,6,3713,20884,17171
leader_crash_restart,0.00,0,1,88,6,3745,20884,17139
leader_crash_restart,0.00,0,1,87,6,3739,20884,17145
leader_crash_restart,0.00,0,1,85,6,3738,20884,17146
leader_crash_restart,0.00,0,1,92,6,3779,20884,17105
leader_crash_restart,0.00,0,1,91,6,3769,20884,17115
leader_crash_restart,0.00,0,1,89,6,3756,20884,17128
leader_crash_restart,0.00,0,1,90,6,3760,20884,17124
leader_crash_restart,0.00,0,1,94,6,3786,20884,17098
leader_crash_restart,0.00,0,1,96,6,3797,20884,17087
leader_crash_restart,0.00,0,1,95,6,3786,20884,17098
leader_crash_restart,0.00,0,1,93,6,3786,20884,17098
leader_crash_restart,0.00,0,1,98,6,3810,20884,17074
leader_crash_restart,0.00,0,1,100,6,3818,20884,17066
leader_crash_restart,0.00,0,1,99,6,3814,20884,17070
leader_crash_restart,0.00,0,1,102,6,3834,20884,17050
leader_crash_restart,0.00,0,1,104,6,3856,20884,17028
leader_crash_restart,0.00,0,1,103,6,3846,20884,17038
leader_crash_restart,0.00,0,1,108,6,3971,20884,16913
leader_crash_restart,0.00,0,1,107,6,3967,20884,16917
leader_crash_restart,0.00,0,1,105,6,3860,20884,17024
leader_crash_restart,0.00,0,1,106,6,3954,20884,16930
leader_crash_restart,0.00,0,1,110,6,3987,20884,16897
leader_crash_restart,0.00,0,1,112,6,4001,20884,16883
leader_crash_restart,0.00,0,1,111,6,3995,20884,16889
leader_crash_restart,0.00,0,1,114,6,4011,20884,16873
leader_crash_restart,0.00,0,1,113,6,4001,20884,16883
leader_crash_restart,0.00,0,1,116,17,4656,20884,16228
leader_crash_restart,0.00,0,1,115,17,4644,20884,16240
leader_crash_restart,0.00,0,1,118,17,4916,20884,15968
leader_crash_restart,0.00,0,1,120,17,5270,20884,15614
leader_crash_restart,0.00,0,1,119,17,4923,20884,15961
leader_crash_restart,0.00,0,1,122,17,5280,20884,15604
leader_crash_restart,0.00,0,1,117,17,4909,20884,15975
leader_crash_restart,0.00,0,1,121,17,5271,20884,15613
leader_crash_restart,0.00,0,1,124,17,5286,20884,15598
leader_crash_restart,0.00,0,1,126,17,5287,20884,15597
leader_crash_restart,0.00,0,1,125,17,5287,20884,15597
leader_crash_restart,0.00,0,1,128,17,5296,20884,15588
leader_crash_restart,0.00,0,1,127,17,5293,20884,15591
leader_crash_restart,0.00,0,1,123,17,5281,20884,15603
leader_crash_restart,0.00,0,1,130,17,5304,20884,15580
leader_crash_restart,0.00,0,1,129,17,5297,20884,15587
leader_crash_restart,0.00,0,1,134,17,5328,20884,15556
leader_crash_restart,0.00,0,1,132,17,5318,20884,15566
leader_crash_restart,0.00,0,1,133,17,5322,20884,15562
leader_crash_restart,0.00,0,1,136,17,5353,20884,15531
leader_crash_restart,0.00,0,1,138,17,5362,20884,15522
leader_crash_restart,0.00,0,1,140,17,5382,20884,15502
leader_crash_restart,0.00,0,1,139,17,5375,20884,15509
leader_crash_restart,0.00,0,1,141,17,5387,20884,15497
leader_crash_restart,0.00,0,1,144,17,5415,20884,15469
leader_crash_restart,0.00,0,1,142,17,5398,20884,15486
leader_crash_restart,0.00,0,1,143,17,5408,20884,15476
leader_crash_restart,0.00,0,1,145,17,5425,20884,15459
leader_crash_restart,0.00,0,1,148,17,5446,20884,15438
leader_crash_restart,0.00,0,1,150,17,5459,20885,15426
leader_crash_restart,0.00,0,1,147,17,5439,20885,15446
leader_crash_restart,0.00,0,1,149,17,5447,20885,15438
leader_crash_restart,0.00,0,1,152,17,5472,20885,15413
leader_crash_restart,0.00,0,1,154,17,5492,20885,15393
leader_crash_restart,0.00,0,1,153,17,5484,20885,15401
leader_crash_restart,0.00,0,1,156,17,5497,20885,15388
leader_crash_restart,0.00,0,1,155,17,5497,20885,15388
leader_crash_restart,0.00,0,1,151,17,5462,20885,15423
leader_crash_restart,0.00,0,1,158,17,5512,20885,15373
leader_crash_restart,0.00,0,1,157,17,5505,20885,15380
leader_crash_restart,0.00,0,1,160,17,5521,20885,15364
leader_crash_restart,0.00,0,1,162,17,5958,20885,14927
leader_crash_restart,0.00,0,1,159,17,5517,20885,15368
leader_crash_restart,0.00,0,1,164,17,6517,20885,14368
leader_crash_restart,0.00,0,1,163,17,6132,20885,14753
leader_crash_restart,0.00,0,1,166,17,6536,20885,14349
leader_crash_restart,0.00,0,1,165,17,6530,20885,14355
leader_crash_restart,0.00,0,1,168,17,6552,20885,14333
leader_crash_restart,0.00,0,1,167,17,6546,20885,14339
leader_crash_restart,0.00,0,1,170,17,6669,20885,14216
leader_crash_restart,0.00,0,1,172,17,6684,20885,14201
leader_crash_restart,0.00,0,1,171,17,6678,20885,14207
leader_crash_restart,0.00,0,1,174,17,7005,20885,13880
leader_crash_restart,0.00,0,1,176,17,7009,20885,13876
leader_crash_restart,0.00,0,1,175,17,7006,20885,13879
leader_crash_restart,0.00,0,1,173,17,6696,20885,14189
leader_crash_restart,0.00,0,1,178,17,7015,20885,13870
leader_crash_restart,0.00,0,1,177,17,7014,20885,13871
leader_crash_restart,0.00,0,1,180,17,7032,20885,13853
leader_crash_restart,0.00,0,1,182,17,7049,20885,13836
leader_crash_restart,0.00,0,1,181,17,7040,20885,13845
leader_crash_restart,0.00,0,1,184,17,7063,20885,13822
leader_crash_restart,0.00,0,1,183,17,7060,20885,13825
leader_crash_restart,0.00,0,1,179,17,7021,20885,13864
leader_crash_restart,0.00,0,1,186,17,7077,20885,13808
leader_crash_restart,0.00,0,1,188,17,7085,20885,13800
leader_crash_restart,0.00,0,1,187,17,7083,20885,13802
leader_crash_restart,0.00,0,1,189,17,7439,20885,13446
leader_crash_restart,0.00,0,1,191,17,7913,20885,12972
leader_crash_restart,0.00,0,1,192,17,7915,20885,12970
leader_crash_restart,0.00,0,1,193,17,7919,20885,12966
leader_crash_restart,0.00,0,1,194,17,7923,20885,12962
leader_crash_restart,0.00,0,1,199,17,8389,20885,12496
leader_crash_restart,0.00,0,1,196,17,7943,20885,12942
leader_crash_restart,0.00,0,1,197,17,8381,20885,12504
leader_crash_restart,0.00,0,1,198,17,8387,20885,12498
leader_crash_restart,0.00,0,1,200,17,8682,20885,12203
leader_crash_restart,0.00,0,1,203,17,8706,20885,12179
leader_crash_restart,0.00,0,1,204,17,8708,20885,12177
leader_crash_restart,0.00,0,1,205,17,8863,20885,12022
leader_crash_restart,0.00,0,1,206,17,8873,20885,12012
leader_crash_restart,0.00,0,1,209,17,8893,20885,11992
leader_crash_restart,0.00,0,1,208,17,8889,20885,11996
leader_crash_restart,0.00,0,1,211,17,8901,20885,11984
leader_crash_restart,0.00,0,1,210,17,8894,20885,11991
leader_crash_restart,0.00,0,1,213,17,8919,20885,11966
leader_crash_restart,0.00,0,1,215,17,8932,20885,11953
leader_crash_restart,0.00,0,1,214,17,8928,20885,11957
leader_crash_restart,0.00,0,1,212,17,8909,20885,11976
leader_crash_restart,0.00,0,1,217,17,8940,20885,11945
leader_crash_restart,0.00,0,1,219,17,8947,20885,11938
leader_crash_restart,0.00,0,1,218,17,8944,20885,11941
leader_crash_restart,0.00,0,1,221,17,8959,20885,11926
leader_crash_restart,0.00,0,1,220,17,8947,20885,11938
leader_crash_restart,0.00,0,1,223,17,8976,20885,11909
leader_crash_restart,0.00,0,1,225,17,8983,20885,11902
leader_crash_restart,0.00,0,1,224,17,8980,20885,11905
leader_crash_restart,0.00,0,1,226,17,8985,20885,11900
leader_crash_restart,0.00,0,1,228,17,9285,20885,11600
leader_crash_restart,0.00,0,1,227,17,8992,20885,11893
leader_crash_restart,0.00,0,1,230,17,9300,20885,11585
leader_crash_restart,0.00,0,1,229,17,9289,20885,11596
leader_crash_restart,0.00,0,1,234,17,9814,20885,11071
leader_crash_restart,0.00,0,1,232,17,9335,20885,11550
leader_crash_restart,0.00,0,1,233,17,9801,20885,11084
leader_crash_restart,0.00,0,1,236,17,10021,20885,10864
leader_crash_restart,0.00,0,1,238,17,10035,20885,10850
leader_crash_restart,0.00,0,1,237,17,10030,20885,10855
leader_crash_restart,0.00,0,1,240,17,10218,20885,10667
leader_crash_restart,0.00,0,1,242,17,10229,20885,10656
leader_crash_restart,0.00,0,1,239,17,10213,20885,10672
leader_crash_restart,0.00,0,1,241,17,10224,20885,10661
leader_crash_restart,0.00,0,1,244,17,10237,20885,10648
leader_crash_restart,0.00,0,1,246,17,10240,20885,10645
leader_crash_restart,0.00,0,1,248,17,10261,20885,10624
leader_crash_restart,0.00,0,1,250,17,10307,20885,10578
leader_crash_restart,0.00,0,1,247,17,10248,20885,10637
leader_crash_restart,0.00,0,1,249,17,10300,20885,10585
leader_crash_restart,0.00,0,1,252,17,10323,20885,10562
leader_crash_restart,0.00,0,1,251,17,10317,20885,10568
leader_crash_restart,0.00,0,1,254,17,10482,20885,10403
leader_crash_restart,0.00,0,1,256,17,10495,20885,10390
leader_crash_restart,0.00,0,1,255,17,10490,20885,10395
leader_crash_restart,0.00,0,1,257,17,10502,20885,10383
leader_crash_restart,0.00,0,1,258,17,10512,20885,10373
leader_crash_restart,0.00,0,1,262,17,10542,20885,10343
leader_crash_restart,0.00,0,1,259,17,10518,20885,10367
leader_crash_restart,0.00,0,1,261,17,10537,20885,10348
leader_crash_restart,0.00,0,1,263,17,10551,20885,10334
leader_crash_restart,0.00,0,1,25,6,2568,20885,18317
leader_crash_restart,0.00,0,1,266,17,10933,20886,9953
leader_crash_restart,0.00,0,1,265,17,10925,20886,9961
leader_crash_restart,0.00,0,1,268,17,10949,20886,9937
leader_crash_restart,0.00,0,1,271,17,11050,20886,9836
leader_crash_restart,0.00,0,1,270,17,10965,20886,9921
leader_crash_restart,0.00,0,1,273,17,11061,20886,9825
leader_crash_restart,0.00,0,1,269,17,10957,20886,9929
leader_crash_restart,0.00,0,1,275,17,11066,20886,9820
leader_crash_restart,0.00,0,1,274,17,11063,20886,9823
leader_crash_restart,0.00,0,1,277,17,11070,20886,9816
leader_crash_restart,0.00,0,1,279,17,11391,20886,9495
leader_crash_restart,0.00,0,1,278,17,11380,20886,9506
leader_crash_restart,0.00,0,1,281,17,11393,20886,9493
leader_crash_restart,0.00,0,1,283,17,11573,20886,9313
leader_crash_restart,0.00,0,1,282,17,11563,20886,9323
leader_crash_restart,0.00,0,1,284,17,11719,20886,9167
leader_crash_restart,0.00,0,1,287,17,11797,20886,9089
leader_crash_restart,0.00,0,1,286,17,11797,20886,9089
leader_crash_restart,0.00,0,1,289,17,12065,20886,8821
leader_crash_restart,0.00,0,1,290,17,12074,20886,8812
leader_crash_restart,0.00,0,1,292,17,12087,20886,8799
leader_crash_restart,0.00,0,1,294,17,12102,20886,8784
leader_crash_restart,0.00,0,1,293,17,12095,20886,8791
leader_crash_restart,0.00,0,1,295,17,12112,20886,8774
leader_crash_restart,0.00,0,1,298,17,12141,20886,8745
leader_crash_restart,0.00,0,1,297,17,12131,20886,8755
leader_crash_restart,0.00,0,1,301,17,12158,20886,8728
leader_crash_restart,0.00,0,1,302,17,12161,20886,8725
leader_crash_restart,0.00,0,1,304,17,12345,20886,8541
leader_crash_restart,0.00,0,1,306,17,12352,20886,8534
leader_crash_restart,0.00,0,1,308,17,12366,20886,8520
leader_crash_restart,0.00,0,1,307,17,12360,20886,8526
leader_crash_restart,0.00,0,1,309,17,12371,20886,8515
leader_crash_restart,0.00,0,1,312,17,12398,20886,8488
leader_crash_restart,0.00,0,1,311,17,12388,20886,8498
leader_crash_restart,0.00,0,1,314,17,12403,20886,8483
leader_crash_restart,0.00,0,1,316,17,12416,20886,8470
leader_crash_restart,0.00,0,1,315,17,12408,20886,8478
leader_crash_restart,0.00,0,1,318,17,12433,20886,8453
leader_crash_restart,0.00,0,1,317,17,12424,20886,8462
leader_crash_restart,0.00,0,1,320,17,12448,20886,8438
leader_crash_restart,0.00,0,1,319,17,12439,20886,8447
leader_crash_restart,0.00,0,1,322,17,12456,20886,8430
leader_crash_restart,0.00,0,1,321,17,12448,20886,8438
leader_crash_restart,0.00,0,1,305,17,12348,20886,8538
leader_crash_restart,0.00,0,1,324,17,12464,20886,8422
leader_crash_restart,0.00,0,1,323,17,12459,20886,8427
leader_crash_restart,0.00,0,1,326,17,12883,20886,8003
leader_crash_restart,0.00,0,1,325,17,12877,20886,8009
leader_crash_restart,0.00,0,1,328,17,12901,20886,7985
leader_crash_restart,0.00,0,1,327,17,12895,20886,7991
leader_crash_restart,0.00,0,1,330,17,12917,20886,7969
leader_crash_restart,0.00,0,1,329,17,12907,20886,7979
leader_crash_restart,0.00,0,1,332,17,12934,20886,7952
leader_crash_restart,0.00,0,1,331,17,12924,20886,7962
leader_crash_restart,0.00,0,1,333,17,12941,20886,7945
leader_crash_restart,0.00,0,1,336,17,13404,20886,7482
leader_crash_restart,0.00,0,1,335,17,13404,20886,7482
leader_crash_restart,0.00,0,1,334,17,13265,20886,7621
leader_crash_restart,0.00,0,1,338,17,13422,20886,7464
leader_crash_restart,0.00,0,1,337,17,13411,20886,7475
leader_crash_restart,0.00,0,1,340,17,13428,20886,7458
leader_crash_restart,0.00,0,1,339,17,13428,20886,7458
leader_crash_restart,0.00,0,1,342,17,13616,20886,7270
leader_crash_restart,0.00,0,1,341,17,13609,20886,7277
leader_crash_restart,0.00,0,1,344,17,13633,20886,7253
leader_crash_restart,0.00,0,1,343,17,13624,20886,7262
leader_crash_restart,0.00,0,1,346,17,13642,20886,7244
leader_crash_restart,0.00,0,1,345,17,13638,20886,7248
leader_crash_restart,0.00,0,1,348,17,13657,20886,7229
leader_crash_restart,0.00,0,1,350,17,13664,20886,7222
leader_crash_restart,0.00,0,1,349,17,13657,20886,7229
leader_crash_restart,0.00,0,1,347,17,13644,20886,7242
leader_crash_restart,0.00,0,1,352,17,13966,20886,6920
leader_crash_restart,0.00,0,1,351,17,13957,20886,6929
leader_crash_restart,0.00,0,1,354,17,14324,20886,6562
leader_crash_restart,0.00,0,1,353,17,14314,20886,6572
leader_crash_restart,0.00,0,1,356,17,14337,20886,6549
leader_crash_restart,0.00,0,1,358,17,14351,20886,6535
leader_crash_restart,0.00,0,1,357,17,14349,20886,6537
leader_crash_restart,0.00,0,1,360,17,14363,20886,6523
leader_crash_restart,0.00,0,1,359,17,14351,20886,6535
leader_crash_restart,0.00,0,1,362,17,14376,20886,6510
leader_crash_restart,0.00,0,1,361,17,14367,20886,6519
leader_crash_restart,0.00,0,1,363,17,14385,20886,6501
leader_crash_restart,0.00,0,1,364,17,14387,20886,6499
leader_crash_restart,0.00,0,1,365,17,14597,20886,6289
leader_crash_restart,0.00,0,1,366,17,14599,20886,6287
leader_crash_restart,0.00,0,1,368,17,15388,20886,5498
leader_crash_restart,0.00,0,1,367,17,14977,20886,5909
leader_crash_restart,0.00,0,1,370,17,15402,20886,5484
leader_crash_restart,0.00,0,1,372,17,15423,20886,5463
leader_crash_restart,0.00,0,1,371,17,15415,20886,5471
leader_crash_restart,0.00,0,1,374,17,15441,20886,5445
leader_crash_restart,0.00,0,1,373,17,15432,20886,5454
leader_crash_restart,0.00,0,1,376,17,15452,20886,5434
leader_crash_restart,0.00,0,1,378,17,15466,20886,5420
leader_crash_restart,0.00,0,1,377,17,15459,20886,5427
leader_crash_restart,0.00,0,1,375,17,15447,20886,5439
leader_crash_restart,0.00,0,1,382,17,15491,20887,5396
leader_crash_restart,0.00,0,1,381,17,15482,20887,5405
leader_crash_restart,0.00,0,1,380,17,15476,20887,5411
leader_crash_restart,0.00,0,1,384,17,15511,20887,5376
leader_crash_restart,0.00,0,1,383,17,15503,20887,5384
leader_crash_restart,0.00,0,1,386,17,15560,20887,5327
leader_crash_restart,0.00,0,1,385,17,15516,20887,5371
leader_crash_restart,0.00,0,1,388,17,15574,20887,5313
leader_crash_restart,0.00,0,1,387,17,15572,20887,5315
leader_crash_restart,0.00,0,1,389,17,15588,20887,5299
leader_crash_restart,0.00,0,1,392,17,15603,20887,5284
leader_crash_restart,0.00,0,1,391,17,15603,20887,5284
leader_crash_restart,0.00,0,1,394,17,15628,20887,5259
leader_crash_restart,0.00,0,1,393,17,15615,20887,5272
leader_crash_restart,0.00,0,1,396,17,15639,20887,5248
leader_crash_restart,0.00,0,1,395,17,15633,20887,5254
leader_crash_restart,0.00,0,1,397,17,15647,20887,5240
leader_crash_restart,0.00,0,1,398,17,15832,20887,5055
leader_crash_restart,0.00,0,1,399,17,15840,20887,5047
leader_crash_restart,0.00,0,1,401,17,15852,20887,5035
leader_crash_restart,0.00,0,1,400,17,15848,20887,5039
leader_crash_restart,0.00,0,1,403,17,15856,20887,5031
leader_crash_restart,0.00,0,1,402,17,15854,20887,5033
leader_crash_restart,0.00,0,1,405,17,15869,20887,5018
leader_crash_restart,0.00,0,1,404,17,15861,20887,5026
leader_crash_restart,0.00,0,1,406,17,15873,20887,5014
leader_crash_restart,0.00,0,1,407,17,15885,20887,5002
leader_crash_restart,0.00,0,1,409,17,15903,20887,4984
leader_crash_restart,0.00,0,1,408,17,15894,20887,4993
leader_crash_restart,0.00,0,1,410,17,15909,20887,4978
leader_crash_restart,0.00,0,1,411,17,15919,20887,4968
leader_crash_restart,0.00,0,1,413,17,15940,20887,4947
leader_crash_restart,0.00,0,1,412,17,15930,20887,4957
leader_crash_restart,0.00,0,1,415,17,15953,20887,4934
leader_crash_restart,0.00,0,1,414,17,15943,20887,4944
leader_crash_restart,0.00,0,1,417,17,15962,20887,4925
leader_crash_restart,0.00,0,1,416,17,15956,20887,4931
leader_crash_restart,0.00,0,1,419,17,15978,20887,4909
leader_crash_restart,0.00,0,1,418,17,15974,20887,4913
leader_crash_restart,0.00,0,1,420,17,15981,20887,4906
leader_crash_restart,0.00,0,1,421,17,15983,20887,4904
leader_crash_restart,0.00,0,1,423,17,15993,20887,4894
leader_crash_restart,0.00,0,1,422,17,15987,20887,4900
leader_crash_restart,0.00,0,1,425,17,16208,20887,4679
leader_crash_restart,0.00,0,1,424,17,16208,20887,4679
leader_crash_restart,0.00,0,1,426,17,16221,20887,4666
leader_crash_restart,0.00,0,1,427,17,16225,20887,4662
leader_crash_restart,0.00,0,1,429,17,16228,20887,4659
leader_crash_restart,0.00,0,1,428,17,16228,20887,4659
leader_crash_restart,0.00,0,1,430,17,16238,20887,4649
leader_crash_restart,0.00,0,1,431,17,16244,20887,4643
leader_crash_restart,0.00,0,1,433,103,20397,20887,490
leader_crash_restart,0.00,0,1,432,103,20387,20887,500
leader_crash_restart,0.00,0,1,5,1,680,27065,26385
leader_crash_restart,0.00,0,1,14,1,734,27065,26331
leader_crash_restart,0.00,0,1,4,1,525,27065,26540
leader_crash_restart,0.00,0,1,32,1,1503,27065,25562
leader_crash_restart,0.00,0,1,45,1,2050,27065,25015
leader_crash_restart,0.00,0,1,46,1,2054,27065,25011
leader_crash_restart,0.00,0,1,7,1,682,27065,26383
leader_crash_restart,0.00,0,1,6,1,682,27065,26383
leader_crash_restart,0.00,0,1,9,1,704,27065,26361
leader_crash_restart,0.00,0,1,8,1,692,27065,26373
leader_crash_restart,0.00,0,1,11,1,714,27065,26351
leader_crash_restart,0.00,0,1,10,1,710,27065,26355
leader_crash_restart,0.00,0,1,13,1,725,27065,26340
leader_crash_restart,0.00,0,1,12,1,722,27065,26343
leader_crash_restart,0.00,0,1,15,1,925,27065,26140
leader_crash_restart,0.00,0,1,17,1,1083,27066,25983
leader_crash_restart,0.00,0,1,16,1,926,27066,26140
leader_crash_restart,0.00,0,1,19,1,1405,27066,25661
leader_crash_restart,0.00,0,1,21,1,1428,27066,25638
leader_crash_restart,0.00,0,1,20,1,1417,27066,25649
leader_crash_restart,0.00,0,1,18,1,1095,27066,25971
leader_crash_restart,0.00,0,1,23,1,1433,27066,25633
leader_crash_restart,0.00,0,1,25,1,1450,27066,25616
leader_crash_restart,0.00,0,1,24,1,1444,27066,25622
leader_crash_restart,0.00,0,1,22,1,1431,27066,25635
leader_crash_restart,0.00,0,1,27,1,1462,27066,25604
leader_crash_restart,0.00,0,1,29,1,1472,27066,25594
leader_crash_restart,0.00,0,1,28,1,1468,27066,25598
leader_crash_restart,0.00,0,1,26,1,1462,27066,25604
leader_crash_restart,0.00,0,1,31,1,1493,27066,25573
leader_crash_restart,0.00,0,1,30,1,1482,27066,25584
leader_crash_restart,0.00,0,1,33,1,1507,27066,25559
leader_crash_restart,0.00,0,1,35,1,1996,27066,25070
leader_crash_restart,0.00,0,1,34,1,1996,27066,25070
leader_crash_restart,0.00,0,1,37,1,2010,27066,25056
leader_crash_restart,0.00,0,1,36,1,2007,27066,25059
leader_crash_restart,0.00,0,1,39,1,2028,27066,25038
leader_crash_restart,0.00,0,1,38,1,2023,27066,25043
leader_crash_restart,0.00,0,1,41,1,2036,27066,25030
leader_crash_restart,0.00,0,1,40,1,2031,27066,25035
leader_crash_restart,0.00,0,1,43,1,2044,27066,25022
leader_crash_restart,0.00,0,1,42,1,2042,27066,25024
leader_crash_restart,0.00,0,1,44,1,2044,27066,25022
leader_crash_restart,0.00,0,1,434,135,26372,27066,694
leader_crash_restart,0.00,0,1,435,135,26384,27066,682
leader_crash_restart,0.00,0,1,437,135,26547,35476,8929
leader_crash_restart,0.00,0,1,436,135,26544,35476,8932
leader_crash_restart,0.00,0,1,448,135,26613,35476,8863
leader_crash_restart,0.00,0,1,439,135,26553,35476,8923
leader_crash_restart,0.00,0,1,438,135,26550,35476,8926
leader_crash_restart,0.00,0,1,441,135,26557,35476,8919
leader_crash_restart,0.00,0,1,455,135,26679,35476,8797
leader_crash_restart,0.00,0,1,440,135,26554,35476,8922
leader_crash_restart,0.00,0,1,443,135,26581,35476,8895
leader_crash_restart,0.00,0,1,470,135,27455,35476,8021
leader_crash_restart,0.00,0,1,473,135,27879,35476,7597
leader_crash_restart,0.00,0,1,477,135,27911,35476,7565
leader_crash_restart,0.00,0,1,487,135,28292,35476,7184
leader_crash_restart,0.00,0,1,491,135,28324,35476,7152
leader_crash_restart,0.00,0,1,502,135,28405,35476,7071
leader_crash_restart,0.00,0,1,503,135,28547,35476,6929
leader_crash_restart,0.00,0,1,507,175,35085,35476,391
leader_crash_restart,0.00,0,1,511,175,35119,35476,357
leader_crash_restart,0.00,0,1,442,135,26568,35476,8908
leader_crash_restart,0.00,0,1,445,135,26591,35476,8885
leader_crash_restart,0.00,0,1,526,175,35203,35476,273
leader_crash_restart,0.00,0,1,444,135,26588,35476,8888
leader_crash_restart,0.00,0,1,447,135,26604,35476,8872
leader_crash_restart,0.00,0,1,446,135,26594,35476,8882
leader_crash_restart,0.00,0,1,449,135,26624,35476,8852
leader_crash_restart,0.00,0,1,450,135,26634,35477,8843
leader_crash_restart,0.00,0,1,452,135,26656,35477,8821
leader_crash_restart,0.00,0,1,451,135,26648,35477,8829
leader_crash_restart,0.00,0,1,454,135,26674,35477,8803
leader_crash_restart,0.00,0,1,453,135,26664,35477,8813
leader_crash_restart,0.00,0,1,456,135,26689,35477,8788
leader_crash_restart,0.00,0,1,458,135,26710,35477,8767
leader_crash_restart,0.00,0,1,457,135,26698,35477,8779
leader_crash_restart,0.00,0,1,460,135,26723,35477,8754
leader_crash_restart,0.00,0,1,462,135,26735,35477,8742
leader_crash_restart,0.00,0,1,461,135,26732,35477,8745
leader_crash_restart,0.00,0,1,459,135,26716,35477,8761
leader_crash_restart,0.00,0,1,464,135,26744,35477,8733
leader_crash_restart,0.00,0,1,463,135,26738,35477,8739
leader_crash_restart,0.00,0,1,466,135,27005,35477,8472
leader_crash_restart,0.00,0,1,465,135,26994,35477,8483
leader_crash_restart,0.00,0,1,468,135,27437,35477,8040
leader_crash_restart,0.00,0,1,467,135,27431,35477,8046
leader_crash_restart,0.00,0,1,469,135,27444,35477,8033
leader_crash_restart,0.00,0,1,472,135,27474,35477,8003
leader_crash_restart,0.00,0,1,471,135,27462,35477,8015
leader_crash_restart,0.00,0,1,474,135,27890,35477,7587
leader_crash_restart,0.00,0,1,476,135,27899,35477,7578
leader_crash_restart,0.00,0,1,475,135,27893,35477,7584
leader_crash_restart,0.00,0,1,478,135,27913,35477,7564
leader_crash_restart,0.00,0,1,479,135,27921,35477,7556
leader_crash_restart,0.00,0,1,482,135,27942,35477,7535
leader_crash_restart,0.00,0,1,481,135,27934,35477,7543
leader_crash_restart,0.00,0,1,480,135,27925,35477,7552
leader_crash_restart,0.00,0,1,484,135,28261,35477,7216
leader_crash_restart,0.00,0,1,483,135,28258,35477,7219
leader_crash_restart,0.00,0,1,486,135,28281,35477,7196
leader_crash_restart,0.00,0,1,485,135,28268,35477,7209
leader_crash_restart,0.00,0,1,488,135,28299,35477,7178
leader_crash_restart,0.00,0,1,489,135,28310,35477,7167
leader_crash_restart,0.00,0,1,490,135,28319,35477,7158
leader_crash_restart,0.00,0,1,492,135,28327,35477,7150
leader_crash_restart,0.00,0,1,494,135,28348,35477,7129
leader_crash_restart,0.00,0,1,493,135,28334,35478,7144
leader_crash_restart,0.00,0,1,496,135,28369,35478,7109
leader_crash_restart,0.00,0,1,498,135,28384,35478,7094
leader_crash_restart,0.00,0,1,497,135,28378,35478,7100
leader_crash_restart,0.00,0,1,500,135,28387,35478,7091
leader_crash_restart,0.00,0,1,499,135,28386,35478,7092
leader_crash_restart,0.00,0,1,495,135,28358,35478,7120
leader_crash_restart,0.00,0,1,504,135,28548,35478,6930
leader_crash_restart,0.00,0,1,501,135,28393,35478,7085
leader_crash_restart,0.00,0,1,506,175,35075,35478,403
leader_crash_restart,0.00,0,1,505,135,28551,35478,6927
leader_crash_restart,0.00,0,1,508,175,35097,35478,381
leader_crash_restart,0.00,0,1,510,175,35112,35478,366
leader_crash_restart,0.00,0,1,509,175,35111,35478,367
leader_crash_restart,0.00,0,1,512,175,35122,35478,356
leader_crash_restart,0.00,0,1,514,175,35141,35478,337
leader_crash_restart,0.00,0,1,513,175,35131,35478,347
leader_crash_restart,0.00,0,1,516,175,35152,35478,326
leader_crash_restart,0.00,0,1,515,175,35145,35478,333
leader_crash_restart,0.00,0,1,518,175,35166,35478,312
leader_crash_restart,0.00,0,1,520,175,35168,35478,310
leader_crash_restart,0.00,0,1,519,175,35167,35478,311
leader_crash_restart,0.00,0,1,517,175,35165,35478,313
leader_crash_restart,0.00,0,1,522,175,35178,35478,300
leader_crash_restart,0.00,0,1,521,175,35176,35478,302
leader_crash_restart,0.00,0,1,523,175,35180,35478,298
leader_crash_restart,0.00,0,1,525,175,35198,35478,280
leader_crash_restart,0.00,0,1,527,175,35214,35478,264
leader_crash_restart,0.00,0,1,524,175,35186,35478,292
leader_crash_restart,0.00,0,1,528,175,35217,35478,261
leader_crash_restart,0.00,0,1,529,175,37242,37363,121
leader_crash_restart,0.00,0,1,2,1,481,502,21
leader_crash_restart,0.00,0,1,1,1,458,502,44
leader_crash_restart,0.00,0,1,3,1,487,502,15
leader_crash_restart,0.00,0,1,5,1,518,603,85
leader_crash_restart,0.00,0,1,4,1,512,603,91
leader_crash_restart,0.00,0,1,6,1,540,603,63
leader_crash_restart,0.00,0,1,8,1,694,704,10
leader_crash_restart,0.00,0,1,7,1,621,704,83
leader_crash_restart,0.00,0,1,9,1,700,704,4
leader_crash_restart,0.00,0,1,11,1,710,804,94
leader_crash_restart,0.00,0,1,10,1,704,804,100
leader_crash_restart,0.00,0,1,12,1,804,804,0
leader_crash_restart,0.00,0,1,14,1,885,904,19
leader_crash_restart,0.00,0,1,13,1,814,904,90
leader_crash_restart,0.00,0,1,15,1,892,904,12
leader_crash_restart,0.00,0,1,17,1,922,1004,82
leader_crash_restart,0.00,0,1,16,1,916,1004,88
leader_crash_restart,0.00,0,1,18,1,995,1004,9
leader_crash_restart,0.00,0,1,20,1,1098,1106,8
leader_crash_restart,0.00,0,1,19,1,1006,1106,100
leader_crash_restart,0.00,0,1,21,1,1105,1106,1
leader_crash_restart,0.00,0,1,23,1,1115,1205,90
leader_crash_restart,0.00,0,1,22,1,1109,1205,96
leader_crash_restart,0.00,0,1,24,1,1188,1205,17
leader_crash_restart,0.00,0,1,26,1,1291,1305,14
leader_crash_restart,0.00,0,1,25,1,1219,1305,86
leader_crash_restart,0.00,0,1,27,1,1296,1305,9
leader_crash_restart,0.00,0,1,28,1,1306,1306,0
leader_crash_restart,0.00,0,1,30,1,1321,1406,85
leader_crash_restart,0.00,0,1,29,1,1316,1406,90
leader_crash_restart,0.00,0,1,31,1,1400,1406,6
leader_crash_restart,0.00,0,1,32,1,1410,1505,95
leader_crash_restart,0.00,0,1,33,1,1498,1506,8
leader_crash_restart,0.00,0,1,34,1,1502,1506,4
leader_crash_restart,0.00,0,1,36,1,1513,1606,93
leader_crash_restart,0.00,0,1,35,1,1509,1606,97
leader_crash_restart,0.00,0,1,37,1,1593,1606,13
leader_crash_restart,0.00,0,1,39,1,1690,1716,26
leader_crash_restart,0.00,0,1,38,1,1623,1717,94
leader_crash_restart,0.00,0,1,40,1,1695,1717,22
leader_crash_restart,0.00,0,1,42,1,1728,1807,79
leader_crash_restart,0.00,0,1,41,1,1728,1807,79
leader_crash_restart,0.00,0,1,43,1,1804,1808,4
leader_crash_restart,0.00,0,1,45,1,1809,1816,7
leader_crash_restart,0.00,0,1,44,1,1809,1816,7
leader_crash_restart,0.00,0,1,46,1,1815,1816,1
leader_crash_restart,0.00,0,1,48,1,1820,1907,87
leader_crash_restart,0.00,0,1,49,1,1825,1907,82
leader_crash_restart,0.00,0,1,47,1,1820,1907,87
leader_crash_restart,0.00,0,1,51,1,2002,2008,6
leader_crash_restart,0.00,0,1,50,1,2002,2008,6
leader_crash_restart,0.00,0,1,52,1,2006,2008,2
leader_crash_restart,0.00,0,1,54,1,2012,2017,5
leader_crash_restart,0.00,0,1,53,1,2012,2017,5
leader_crash_restart,0.00,0,1,56,1,2023,2108,85
leader_crash_restart,0.00,0,1,55,1,2017,2108,91
leader_crash_restart,0.00,0,1,57,1,2023,2108,85
leader_crash_restart,0.00,0,1,59,1,2205,2209,4
leader_crash_restart,0.00,0,1,58,1,2199,2209,10
leader_crash_restart,0.00,0,1,60,1,2205,2209,4
leader_crash_restart,0.00,0,1,61,1,2209,2218,9
leader_crash_restart,0.00,0,1,62,1,2215,2218,3
leader_crash_restart,0.00,0,1,63,1,2215,2218,3
leader_crash_restart,0.00,0,1,65,1,2225,2309,84
leader_crash_restart,0.00,0,1,64,1,2220,2309,89
leader_crash_restart,0.00,0,1,66,1,2225,2309,84
leader_crash_restart,0.00,0,1,68,1,2407,2410,3
leader_crash_restart,0.00,0,1,67,1,2401,2410,9
leader_crash_restart,0.00,0,1,69,1,2407,2410,3
leader_crash_restart,0.00,0,1,71,1,2418,2419,1
leader_crash_restart,0.00,0,1,70,1,2411,2419,8
leader_crash_restart,0.00,0,1,72,1,2418,2419,1
leader_crash_restart,0.00,0,1,74,1,2428,2510,82
leader_crash_restart,0.00,0,1,73,1,2422,2510,88
leader_crash_restart,0.00,0,1,75,1,2428,2510,82
leader_crash_restart,0.00,0,1,77,1,2610,2611,1
leader_crash_restart,0.00,0,1,76,1,2603,2611,8
leader_crash_restart,0.00,0,1,78,1,2610,2611,1
leader_crash_restart,0.00,0,1,79,1,2613,2619,6
leader_crash_restart,0.00,0,1,81,1,2620,2710,90
leader_crash_restart,0.00,0,1,80,1,2620,2711,91
leader_crash_restart,0.00,0,1,82,1,2624,2711,87
leader_crash_restart,0.00,0,1,84,1,2802,2812,10
leader_crash_restart,0.00,0,1,83,1,2802,2812,10
leader_crash_restart,0.00,0,1,85,1,2805,2812,7
leader_crash_restart,0.00,0,1,86,1,2816,2819,3
leader_crash_restart,0.00,0,1,87,1,2826,2911,85
leader_crash_restart,0.00,0,1,88,1,2832,2911,79
leader_crash_restart,0.00,0,1,89,1,2832,2911,79
leader_crash_restart,0.00,0,1,91,1,2914,2920,6
leader_crash_restart,0.00,0,1,90,1,2914,2920,6
leader_crash_restart,0.00,0,1,93,1,2925,3012,87
leader_crash_restart,0.00,0,1,92,1,2925,3012,87
leader_crash_restart,0.00,0,1,94,1,3008,3012,4
leader_crash_restart,0.00,0,1,95,1,3019,3020,1
leader_crash_restart,0.00,0,1,97,1,3106,3113,7
leader_crash_restart,0.00,0,1,98,1,3106,3113,7
leader_crash_restart,0.00,0,1,96,1,3029,3113,84
leader_crash_restart,0.00,0,1,100,1,3117,3121,4
leader_crash_restart,0.00,0,1,99,1,3117,3121,4
leader_crash_restart,0.00,0,1,102,1,3127,3213,86
leader_crash_restart,0.00,0,1,101,1,3127,3213,86
leader_crash_restart,0.00,0,1,103,1,3211,3213,2
leader_crash_restart,0.00,0,1,105,1,3309,3313,4
leader_crash_restart,0.00,0,1,104,1,3221,3313,92
leader_crash_restart,0.00,0,1,106,1,3309,3313,4
leader_crash_restart,0.00,0,1,108,1,3319,3321,2
leader_crash_restart,0.00,0,1,107,1,3319,3321,2
leader_crash_restart,0.00,0,1,110,1,3330,3413,83
leader_crash_restart,0.00,0,1,109,1,3330,3414,84
leader_crash_restart,0.00,0,1,111,1,3402,3414,12
leader_crash_restart,0.00,0,1,113,1,3511,3515,4
leader_crash_restart,0.00,0,1,112,1,3433,3515,82
leader_crash_restart,0.00,0,1,114,1,3511,3515,4
leader_crash_restart,0.00,0,1,115,1,3521,3522,1
leader_crash_restart,0.00,0,1,116,1,3521,3522,1
leader_crash_restart,0.00,0,1,118,1,3532,3613,81
leader_crash_restart,0.00,0,1,117,1,3532,3613,81
leader_crash_restart,0.00,0,1,119,1,3615,3623,8
leader_crash_restart,0.00,0,1,121,1,3713,3714,1
leader_crash_restart,0.00,0,1,120,1,3625,3714,89
leader_crash_restart,0.00,0,1,122,1,3713,3714,1
leader_crash_restart,0.00,0,1,124,1,3724,3814,90
leader_crash_restart,0.00,0,1,123,1,3724,3815,91
leader_crash_restart,0.00,0,1,125,1,3807,3815,8
leader_crash_restart,0.00,0,1,126,1,3818,3824,6
leader_crash_restart,0.00,0,1,128,1,3905,3914,9
leader_crash_restart,0.00,0,1,127,1,3828,3914,86
leader_crash_restart,0.00,0,1,129,1,3905,3914,9
leader_crash_restart,0.00,0,1,131,1,3915,3924,9
leader_crash_restart,0.00,0,1,130,1,3915,3924,9
leader_crash_restart,0.00,0,1,133,1,3926,4015,89
leader_crash_restart,0.00,0,1,132,1,3926,4015,89
leader_crash_restart,0.00,0,1,134,1,4010,4015,5
leader_crash_restart,0.00,0,1,135,1,4020,4024,4
leader_crash_restart,0.00,0,1,137,1,4108,4115,7
leader_crash_restart,0.00,0,1,136,1,4030,4115,85
leader_crash_restart,0.00,0,1,138,1,4108,4115,7
leader_crash_restart,0.00,0,1,140,1,4118,4125,7
leader_crash_restart,0.00,0,1,139,1,4118,4126,8
leader_crash_restart,0.00,0,1,141,1,4129,4215,86
leader_crash_restart,0.00,0,1,142,1,4130,4216,86
leader_crash_restart,0.00,0,1,143,1,4211,4216,5
leader_crash_restart,0.00,0,1,144,1,4222,4225,3
leader_crash_restart,0.00,0,1,146,1,4310,4318,8
leader_crash_restart,0.00,0,1,145,1,4232,4318,86
leader_crash_restart,0.00,0,1,147,1,4312,4318,6
leader_crash_restart,0.00,0,1,149,1,4322,4326,4
leader_crash_restart,0.00,0,1,148,1,4320,4326,6
leader_crash_restart,0.00,0,1,151,1,4332,4416,84
leader_crash_restart,0.00,0,1,150,1,4331,4417,86
leader_crash_restart,0.00,0,1,152,1,4413,4417,4
leader_crash_restart,0.00,0,1,153,1,4424,4425,1
leader_crash_restart,0.00,0,1,155,1,4512,4517,5
leader_crash_restart,0.00,0,1,154,1,4435,4517,82
leader_crash_restart,0.00,0,1,156,1,4513,4517,4
leader_crash_restart,0.00,0,1,158,1,4523,4526,3
leader_crash_restart,0.00,0,1,157,1,4522,4526,4
leader_crash_restart,0.00,0,1,159,1,4533,4617,84
leader_crash_restart,0.00,0,1,160,1,4534,4618,84
leader_crash_restart,0.00,0,1,161,1,4616,4618,2
leader_crash_restart,0.00,0,1,163,1,4715,4717,2
leader_crash_restart,0.00,0,1,162,1,4626,4718,92
leader_crash_restart,0.00,0,1,164,1,4715,4718,3
leader_crash_restart,0.00,0,1,166,1,4726,4728,2
leader_crash_restart,0.00,0,1,165,1,4726,4728,2
leader_crash_restart,0.00,0,1,168,1,4736,4818,82
leader_crash_restart,0.00,0,1,167,1,4736,4818,82
leader_crash_restart,0.00,0,1,169,1,4807,4818,11
leader_crash_restart,0.00,0,1,171,1,4918,6333,1415
leader_crash_restart,0.00,0,1,176,1,5603,6333,730
leader_crash_restart,0.00,0,1,180,1,6063,6333,270
leader_crash_restart,0.00,0,1,170,1,4838,6333,1495
leader_crash_restart,0.00,0,1,173,1,5221,6333,1112
leader_crash_restart,0.00,0,1,172,1,4918,6333,1415
leader_crash_restart,0.00,0,1,174,1,5300,6333,1033
leader_crash_restart,0.00,0,1,175,1,5300,6333,1033
leader_crash_restart,0.00,0,1,177,1,5681,6333,652
leader_crash_restart,0.00,0,1,179,1,5984,6333,349
leader_crash_restart,0.00,0,1,178,1,5682,6333,651
leader_crash_restart,0.00,0,1,181,1,6064,6333,269
leader_crash_restart,0.00,0,1,182,1,6367,6426,59
leader_crash_restart,0.00,0,1,184,1,6447,6525,78
leader_crash_restart,0.00,0,1,183,1,6446,6526,80
leader_crash_restart,0.00,0,1,185,1,6448,6526,78
leader_crash_restart,0.00,0,1,186,1,6527,6535,8
leader_crash_restart,0.00,0,1,187,1,6528,6535,7
leader_crash_restart,0.00,0,1,188,1,6528,6535,7
leader_crash_restart,0.00,0,1,190,1,6539,6625,86
leader_crash_restart,0.00,0,1,189,1,6538,6626,88
leader_crash_restart,0.00,0,1,191,1,6539,6626,87
leader_crash_restart,0.00,0,1,193,1,6720,6725,5
leader_crash_restart,0.00,0,1,192,1,6719,6726,7
leader_crash_restart,0.00,0,1,194,1,6720,6726,6
leader_crash_restart,0.00,0,1,196,1,6731,6736,5
leader_crash_restart,0.00,0,1,195,1,6730,6737,7
leader_crash_restart,0.00,0,1,197,1,6731,6737,6
leader_crash_restart,0.00,0,1,199,1,6741,6826,85
leader_crash_restart,0.00,0,1,198,1,6740,6826,86
leader_crash_restart,0.00,0,1,200,1,6741,6826,85
leader_crash_restart,0.00,0,1,202,1,6923,6926,3
leader_crash_restart,0.00,0,1,201,1,6922,6926,4
leader_crash_restart,0.00,0,1,203,1,6923,6926,3
leader_crash_restart,0.00,0,1,205,1,6933,6937,4
leader_crash_restart,0.00,0,1,204,1,6932,6937,5
leader_crash_restart,0.00,0,1,206,1,6933,6937,4
leader_crash_restart,0.00,0,1,208,1,6944,7428,484
leader_crash_restart,0.00,0,1,207,1,6943,7428,485
leader_crash_restart,0.00,0,1,210,11,7404,7428,24
leader_crash_restart,0.00,0,1,209,1,6944,7428,484
leader_crash_restart,0.00,0,1,211,11,7422,7428,6
leader_crash_restart,0.00,0,1,213,11,7435,7528,93
leader_crash_restart,0.00,0,1,214,11,7439,7528,89
leader_crash_restart,0.00,0,1,212,11,7433,7528,95
leader_crash_restart,0.00,0,1,216,11,7617,7628,11
leader_crash_restart,0.00,0,1,215,11,7617,7628,11
leader_crash_restart,0.00,0,1,217,11,7620,7628,8
leader_crash_restart,0.00,0,1,219,11,7648,7729,81
leader_crash_restart,0.00,0,1,218,11,7631,7729,98
leader_crash_restart,0.00,0,1,220,11,7648,7729,81
leader_crash_restart,0.00,0,1,221,11,7812,7829,17
leader_crash_restart,0.00,0,1,222,11,7829,7830,1
leader_crash_restart,0.00,0,1,223,11,7831,7931,100
leader_crash_restart,0.00,0,1,224,11,7841,7931,90
leader_crash_restart,0.00,0,1,225,11,7843,7931,88
leader_crash_restart,0.00,0,1,227,11,8022,8031,9
leader_crash_restart,0.00,0,1,226,11,8016,8031,15
leader_crash_restart,0.00,0,1,228,11,8027,8031,4
leader_crash_restart,0.00,0,1,230,11,8037,8132,95
leader_crash_restart,0.00,0,1,229,11,8032,8132,100
leader_crash_restart,0.00,0,1,231,11,8047,8132,85
leader_crash_restart,0.00,0,1,232,11,8214,8231,17
leader_crash_restart,0.00,0,1,233,11,8219,8231,12
leader_crash_restart,0.00,0,1,234,11,8229,8231,2
leader_crash_restart,0.00,0,1,236,11,8245,8330,85
leader_crash_restart,0.00,0,1,235,11,8239,8330,91
leader_crash_restart,0.00,0,1,237,11,8250,8330,80
leader_crash_restart,0.00,0,1,238,11,8332,8333,1
leader_crash_restart,0.00,0,1,240,11,8421,8431,10
leader_crash_restart,0.00,0,1,239,11,8342,8432,90
leader_crash_restart,0.00,0,1,241,11,8426,8432,6
leader_crash_restart,0.00,0,1,243,11,8451,8531,80
leader_crash_restart,0.00,0,1,242,11,8437,8531,94
leader_crash_restart,0.00,0,1,244,11,8524,8531,7
leader_crash_restart,0.00,0,1,245,11,8533,8533,0
leader_crash_restart,0.00,0,1,247,11,8543,8633,90
leader_crash_restart,0.00,0,1,246,11,8535,8633,98
leader_crash_restart,0.00,0,1,248,11,8618,8633,15
leader_crash_restart,0.00,0,1,250,11,8717,8732,15
leader_crash_restart,0.00,0,1,249,11,8649,8733,84
leader_crash_restart,0.00,0,1,251,11,8725,8733,8
leader_crash_restart,0.00,0,1,253,11,8747,8833,86
leader_crash_restart,0.00,0,1,252,11,8735,8833,98
leader_crash_restart,0.00,0,1,254,11,8831,8833,2
leader_crash_restart,0.00,0,1,256,11,8916,8933,17
leader_crash_restart,0.00,0,1,255,11,8841,8933,92
leader_crash_restart,0.00,0,1,257,11,8929,8933,4
leader_crash_restart,0.00,0,1,259,11,8947,9033,86
leader_crash_restart,0.00,0,1,258,11,8940,9033,93
leader_crash_restart,0.00,0,1,260,11,9022,9033,11
leader_crash_restart,0.00,0,1,262,11,9121,9133,12
leader_crash_restart,0.00,0,1,261,11,9053,9133,80
leader_crash_restart,0.00,0,1,263,11,9128,9133,5
leader_crash_restart,0.00,0,1,264,11,9134,9137,3
leader_crash_restart,0.00,0,1,266,11,9159,9234,75
leader_crash_restart,0.00,0,1,265,11,9159,9234,75
leader_crash_restart,0.00,0,1,267,11,9159,9234,75
leader_crash_restart,0.00,0,1,269,11,9241,9334,93
leader_crash_restart,0.00,0,1,268,11,9240,9335,95
leader_crash_restart,0.00,0,1,270,11,9241,9335,94
leader_crash_restart,0.00,0,1,272,11,9423,9434,11
leader_crash_restart,0.00,0,1,271,11,9422,9436,14
leader_crash_restart,0.00,0,1,273,11,9423,9436,13
leader_crash_restart,0.00,0,1,275,11,9453,9535,82
leader_crash_restart,0.00,0,1,274,11,9453,9536,83
leader_crash_restart,0.00,0,1,276,11,9453,9536,83
leader_crash_restart,0.00,0,1,278,11,9635,9639,4
leader_crash_restart,0.00,0,1,277,11,9635,9639,4
leader_crash_restart,0.00,0,1,279,11,9635,9639,4
leader_crash_restart,0.00,0,1,281,11,9645,9737,92
leader_crash_restart,0.00,0,1,280,11,9645,9737,92
leader_crash_restart,0.00,0,1,282,11,9646,9737,91
leader_crash_restart,0.00,0,1,284,11,9827,9836,9
leader_crash_restart,0.00,0,1,283,11,9827,9836,9
leader_crash_restart,0.00,0,1,285,11,9827,9836,9
leader_crash_restart,0.00,0,1,287,11,9837,9839,2
leader_crash_restart,0.00,0,1,286,11,9837,9840,3
leader_crash_restart,0.00,0,1,288,11,9837,9840,3
leader_crash_restart,0.00,0,1,290,11,9848,9936,88
leader_crash_restart,0.00,0,1,289,11,9848,9937,89
leader_crash_restart,0.00,0,1,291,11,9848,9937,89
leader_crash_restart,0.00,0,1,293,11,10029,10038,9
leader_crash_restart,0.00,0,1,292,11,10029,10038,9
leader_crash_restart,0.00,0,1,294,11,10029,10038,9
leader_crash_restart,0.00,0,1,296,11,10040,10041,1
leader_crash_restart,0.00,0,1,295,11,10040,10041,1
leader_crash_restart,0.00,0,1,297,11,10040,10041,1
leader_crash_restart,0.00,0,1,299,11,10050,10139,89
leader_crash_restart,0.00,0,1,298,11,10050,10139,89
leader_crash_restart,0.00,0,1,300,11,10050,10139,89
leader_crash_restart,0.00,0,1,302,11,10232,10237,5
leader_crash_restart,0.00,0,1,301,11,10232,10238,6
leader_crash_restart,0.00,0,1,303,11,10232,10238,6
leader_crash_restart,0.00,0,1,305,11,10243,10338,95
leader_crash_restart,0.00,0,1,304,11,10243,10338,95
leader_crash_restart,0.00,0,1,306,11,10243,10338,95
leader_crash_restart,0.00,0,1,308,11,10424,10438,14
leader_crash_restart,0.00,0,1,307,11,10424,10438,14
leader_crash_restart,0.00,0,1,309,11,10424,10438,14
leader_crash_restart,0.00,0,1,311,11,10456,15071,4615
leader_crash_restart,0.00,0,1,310,11,10456,15072,4616
leader_crash_restart,0.00,0,1,313,11,10838,15072,4234
leader_crash_restart,0.00,0,1,312,11,10456,15072,4616
leader_crash_restart,0.00,0,1,315,11,10838,15072,4234
leader_crash_restart,0.00,0,1,314,11,10838,15072,4234
leader_crash_restart,0.00,0,1,317,11,11220,15072,3852
leader_crash_restart,0.00,0,1,316,11,11220,15072,3852
leader_crash_restart,0.00,0,1,319,11,11602,15072,3470
leader_crash_restart,0.00,0,1,318,11,11220,15072,3852
leader_crash_restart,0.00,0,1,321,11,11602,15072,3470
leader_crash_restart,0.00,0,1,320,11,11602,15072,3470
leader_crash_restart,0.00,0,1,323,11,11985,15072,3087
leader_crash_restart,0.00,0,1,322,11,11984,15072,3088
leader_crash_restart,0.00,0,1,325,11,12367,15072,2705
leader_crash_restart,0.00,0,1,324,11,11987,15072,3085
leader_crash_restart,0.00,0,1,327,11,12368,15072,2704
leader_crash_restart,0.00,0,1,326,11,12367,15072,2705
leader_crash_restart,0.00,0,1,329,11,12750,15072,2322
leader_crash_restart,0.00,0,1,328,11,12750,15072,2322
leader_crash_restart,0.00,0,1,331,11,13132,15072,1940
leader_crash_restart,0.00,0,1,330,11,12751,15072,2321
leader_crash_restart,0.00,0,1,333,11,13133,15072,1939
leader_crash_restart,0.00,0,1,332,11,13132,15072,1940
leader_crash_restart,0.00,0,1,335,11,13515,15072,1557
leader_crash_restart,0.00,0,1,334,11,13515,15072,1557
leader_crash_restart,0.00,0,1,337,11,13898,15072,1174
leader_crash_restart,0.00,0,1,336,11,13516,15072,1556
leader_crash_restart,0.00,0,1,339,11,13898,15072,1174
leader_crash_restart,0.00,0,1,338,11,13898,15072,1174
leader_crash_restart,0.00,0,1,341,11,14281,15072,791
leader_crash_restart,0.00,0,1,340,11,14281,15072,791
leader_crash_restart,0.00,0,1,343,11,14663,15072,409
leader_crash_restart,0.00,0,1,342,11,14281,15072,791
leader_crash_restart,0.00,0,1,345,11,14663,15072,409
leader_crash_restart,0.00,0,1,344,11,14663,15072,409
leader_crash_restart,0.00,0,1,346,11,16046,16060,14
leader_crash_restart,0.00,0,1,2,1,343,1024,681
leader_crash_restart,0.00,0,1,1,1,320,1024,704
leader_crash_restart,0.00,0,1,4,4,940,1024,84
leader_crash_restart,0.00,0,1,3,1,389,1024,635
leader_crash_restart,0.00,0,1,6,4,963,1024,61
leader_crash_restart,0.00,0,1,5,4,951,1024,73
leader_crash_restart,0.00,0,1,8,4,1044,1125,81
leader_crash_restart,0.00,0,1,7,4,1032,1125,93
leader_crash_restart,0.00,0,1,9,4,1123,1130,7
leader_crash_restart,0.00,0,1,10,4,1133,1223,90
leader_crash_restart,0.00,0,1,11,4,1213,1244,31
leader_crash_restart,0.00,0,1,13,4,1293,1329,36
leader_crash_restart,0.00,0,1,12,4,1225,1329,104
leader_crash_restart,0.00,0,1,14,4,1314,1336,22
leader_crash_restart,0.00,0,1,15,14,3634,3751,117
leader_crash_restart,0.00,0,1,17,14,3695,3752,57
leader_crash_restart,0.00,0,1,16,14,3664,3752,88
leader_crash_restart,0.00,0,1,18,14,3776,3835,59
leader_crash_restart,0.00,0,1,19,14,3816,3837,21
leader_crash_restart,0.00,0,1,21,14,3846,3939,93
leader_crash_restart,0.00,0,1,20,14,3846,3939,93
leader_crash_restart,0.00,0,1,22,14,3857,3939,82
leader_crash_restart,0.00,0,1,24,14,4027,4044,17
leader_crash_restart,0.00,0,1,23,14,4027,4044,17
leader_crash_restart,0.00,0,1,26,14,4058,4124,66
leader_crash_restart,0.00,0,1,25,14,4038,4124,86
leader_crash_restart,0.00,0,1,27,14,4058,4124,66
leader_crash_restart,0.00,0,1,29,14,4139,4241,102
leader_crash_restart,0.00,0,1,28,14,4139,4241,102
leader_crash_restart,0.00,0,1,30,14,4219,4244,25
leader_crash_restart,0.00,0,1,31,14,4249,4342,93
leader_crash_restart,0.00,0,1,33,14,4321,4358,37
leader_crash_restart,0.00,0,1,32,14,4321,4358,37
leader_crash_restart,0.00,0,1,35,14,4402,4437,35
leader_crash_restart,0.00,0,1,34,14,4402,4437,35
leader_crash_restart,0.00,0,1,36,14,4430,4452,22
leader_crash_restart,0.00,0,1,38,14,4483,4534,51
leader_crash_restart,0.00,0,1,37,14,4461,4535,74
leader_crash_restart,0.00,0,1,39,14,4483,4535,52
leader_crash_restart,0.00,0,1,41,14,4564,4627,63
leader_crash_restart,0.00,0,1,40,14,4542,4628,86
leader_crash_restart,0.00,0,1,42,14,4564,4628,64
leader_crash_restart,0.00,0,1,44,14,4645,4732,87
leader_crash_restart,0.00,0,1,43,14,4645,4732,87
leader_crash_restart,0.00,0,1,45,14,4723,4820,97
leader_crash_restart,0.00,0,1,47,14,4826,4856,30
leader_crash_restart,0.00,0,1,46,14,4826,4856,30
leader_crash_restart,0.00,0,1,49,14,4907,4921,14
leader_crash_restart,0.00,0,1,48,14,4904,4921,17
leader_crash_restart,0.00,0,1,50,14,4907,4921,14
leader_crash_restart,0.00,0,1,51,14,4935,4942,7
leader_crash_restart,0.00,0,1,53,14,4938,5041,103
leader_crash_restart,0.00,0,1,52,14,4938,5041,103
leader_crash_restart,0.00,0,1,54,14,4945,5041,96
leader_crash_restart,0.00,0,1,56,14,5119,5132,13
leader_crash_restart,0.00,0,1,55,14,5119,5132,13
leader_crash_restart,0.00,0,1,58,14,5150,5238,88
leader_crash_restart,0.00,0,1,57,14,5127,5238,111
leader_crash_restart,0.00,0,1,59,14,5150,5238,88
leader_crash_restart,0.00,0,1,60,14,5308,5343,35
leader_crash_restart,0.00,0,1,62,14,5331,5343,12
leader_crash_restart,0.00,0,1,61,14,5331,5343,12
leader_crash_restart,0.00,0,1,64,14,5362,5442,80
leader_crash_restart,0.00,0,1,63,14,5362,5443,81
leader_crash_restart,0.00,0,1,65,14,5390,5443,53
leader_crash_restart,0.00,0,1,67,14,5443,5538,95
leader_crash_restart,0.00,0,1,66,14,5443,5538,95
leader_crash_restart,0.00,0,1,68,14,5471,5538,67
leader_crash_restart,0.00,0,1,69,14,5552,5623,71
leader_crash_restart,0.00,0,1,71,14,5625,5648,23
leader_crash_restart,0.00,0,1,70,14,5625,5648,23
leader_crash_restart,0.00,0,1,72,14,5634,5648,14
leader_crash_restart,0.00,0,1,74,14,5656,5745,89
leader_crash_restart,0.00,0,1,73,14,5656,5745,89
leader_crash_restart,0.00,0,1,75,14,5664,5745,81
leader_crash_restart,0.00,0,1,77,14,5838,5844,6
leader_crash_restart,0.00,0,1,76,14,5746,5844,98
leader_crash_restart,0.00,0,1,78,14,5838,5844,6
leader_crash_restart,0.00,0,1,80,14,5849,5952,103
leader_crash_restart,0.00,0,1,79,14,5849,5952,103
leader_crash_restart,0.00,0,1,81,14,5928,5952,24
leader_crash_restart,0.00,0,1,82,14,5958,6045,87
leader_crash_restart,0.00,0,1,84,14,6033,6056,23
leader_crash_restart,0.00,0,1,83,14,6033,6056,23
leader_crash_restart,0.00,0,1,86,14,6064,6143,79
leader_crash_restart,0.00,0,1,85,14,6064,6143,79
leader_crash_restart,0.00,0,1,87,14,6140,6160,20
leader_crash_restart,0.00,0,1,89,14,6145,6227,82
leader_crash_restart,0.00,0,1,88,14,6145,6227,82
leader_crash_restart,0.00,0,1,90,14,6171,6227,56
leader_crash_restart,0.00,0,1,91,14,6252,6347,95
leader_crash_restart,0.00,0,1,93,14,6327,6362,35
leader_crash_restart,0.00,0,1,92,14,6327,6362,35
leader_crash_restart,0.00,0,1,95,14,6407,6437,30
leader_crash_restart,0.00,0,1,94,14,6407,6437,30
leader_crash_restart,0.00,0,1,97,14,6439,6564,125
leader_crash_restart,0.00,0,1,96,14,6434,6565,131
leader_crash_restart,0.00,0,1,98,14,6439,6565,126
leader_crash_restart,0.00,0,1,100,14,6620,6646,26
leader_crash_restart,0.00,0,1,99,14,6616,6646,30
leader_crash_restart,0.00,0,1,101,14,6620,6646,26
leader_crash_restart,0.00,0,1,103,14,6651,6744,93
leader_crash_restart,0.00,0,1,102,14,6647,6745,98
leader_crash_restart,0.00,0,1,104,14,6651,6745,94
leader_crash_restart,0.00,0,1,106,14,6833,6868,35
leader_crash_restart,0.00,0,1,105,14,6829,6868,39
leader_crash_restart,0.00,0,1,107,14,6833,6868,35
leader_crash_restart,0.00,0,1,109,14,6914,6943,29
leader_crash_restart,0.00,0,1,108,14,6910,6943,33
leader_crash_restart,0.00,0,1,110,14,6914,6943,29
leader_crash_restart,0.00,0,1,111,22,8164,8255,91
leader_crash_restart,0.00,0,1,112,22,8187,8256,69
leader_crash_restart,0.00,0,1,114,22,8269,8351,82
leader_crash_restart,0.00,0,1,113,22,8237,8351,114
leader_crash_restart,0.00,0,1,115,22,8345,8447,102
leader_crash_restart,0.00,0,1,116,22,8420,8448,28
leader_crash_restart,0.00,0,1,118,22,8450,8451,1
leader_crash_restart,0.00,0,1,117,22,8450,8451,1
leader_crash_restart,0.00,0,1,120,22,8461,8552,91
leader_crash_restart,0.00,0,1,119,22,8461,8552,91
leader_crash_restart,0.00,0,1,121,22,8526,8552,26
leader_crash_restart,0.00,0,1,122,22,8557,8653,96
leader_crash_restart,0.00,0,1,124,22,8643,8660,17
leader_crash_restart,0.00,0,1,123,22,8643,8660,17
leader_crash_restart,0.00,0,1,126,22,8674,8751,77
leader_crash_restart,0.00,0,1,125,22,8674,8752,78
leader_crash_restart,0.00,0,1,127,22,8739,8767,28
leader_crash_restart,0.00,0,1,129,22,8755,8843,88
leader_crash_restart,0.00,0,1,128,22,8755,8844,89
leader_crash_restart,0.00,0,1,130,22,8770,8844,74
leader_crash_restart,0.00,0,1,131,22,8851,8865,14
leader_crash_restart,0.00,0,1,133,22,8936,8952,16
leader_crash_restart,0.00,0,1,132,22,8882,8952,70
leader_crash_restart,0.00,0,1,134,22,8936,8952,16
leader_crash_restart,0.00,0,1,136,22,8967,9045,78
leader_crash_restart,0.00,0,1,135,22,8964,9046,82
leader_crash_restart,0.00,0,1,137,22,8967,9046,79
leader_crash_restart,0.00,0,1,139,22,9048,9069,21
leader_crash_restart,0.00,0,1,138,22,9048,9069,21
leader_crash_restart,0.00,0,1,141,22,9079,9146,67
leader_crash_restart,0.00,0,1,140,22,9079,9146,67
leader_crash_restart,0.00,0,1,142,22,9145,9178,33
leader_crash_restart,0.00,0,1,144,22,9160,9253,93
leader_crash_restart,0.00,0,1,143,22,9159,9253,94
leader_crash_restart,0.00,0,1,145,22,9226,9253,27
leader_crash_restart,0.00,0,1,146,22,9257,9348,91
leader_crash_restart,0.00,0,1,148,22,9342,9360,18
leader_crash_restart,0.00,0,1,147,22,9341,9361,20
leader_crash_restart,0.00,0,1,150,22,9373,9445,72
leader_crash_restart,0.00,0,1,149,22,9372,9445,73
leader_crash_restart,0.00,0,1,152,22,9453,9456,3
leader_crash_restart,0.00,0,1,151,22,9440,9456,16
leader_crash_restart,0.00,0,1,154,22,9463,9549,86
leader_crash_restart,0.00,0,1,153,22,9454,9549,95
leader_crash_restart,0.00,0,1,155,22,9470,9549,79
leader_crash_restart,0.00,0,1,156,22,9552,9565,13
leader_crash_restart,0.00,0,1,158,22,9636,9656,20
leader_crash_restart,0.00,0,1,157,22,9582,9657,75
leader_crash_restart,0.00,0,1,159,22,9644,9675,31
leader_crash_restart,0.00,0,1,161,22,9667,9753,86
leader_crash_restart,0.00,0,1,160,22,9663,9753,90
leader_crash_restart,0.00,0,1,162,22,9725,9753,28
leader_crash_restart,0.00,0,1,164,22,9845,9858,13
leader_crash_restart,0.00,0,1,163,22,9756,9859,103
leader_crash_restart,0.00,0,1,165,22,9848,9859,11
leader_crash_restart,0.00,0,1,167,22,9876,9962,86
leader_crash_restart,0.00,0,1,166,22,9859,9962,103
leader_crash_restart,0.00,0,1,168,22,9937,9962,25
leader_crash_restart,0.00,0,1,170,22,10040,10058,18
leader_crash_restart,0.00,0,1,169,22,9968,10058,90
leader_crash_restart,0.00,0,1,172,22,10071,10159,88
leader_crash_restart,0.00,0,1,171,22,10057,10159,102
leader_crash_restart,0.00,0,1,173,22,10149,10179,30
leader_crash_restart,0.00,0,1,175,22,10239,10265,26
leader_crash_restart,0.00,0,1,174,22,10180,10265,85
leader_crash_restart,0.00,0,1,176,22,10252,10265,13
leader_crash_restart,0.00,0,1,178,22,10283,10350,67
leader_crash_restart,0.00,0,1,177,22,10269,10350,81
leader_crash_restart,0.00,0,1,179,22,10350,10379,29
leader_crash_restart,0.00,0,1,181,22,10363,10447,84
leader_crash_restart,0.00,0,1,180,22,10361,10447,86
leader_crash_restart,0.00,0,1,182,22,10381,10447,66
leader_crash_restart,0.00,0,1,183,22,10462,10555,93
leader_crash_restart,0.00,0,1,185,22,10545,10574,29
leader_crash_restart,0.00,0,1,184,22,10543,10574,31
leader_crash_restart,0.00,0,1,187,22,10576,10665,89
leader_crash_restart,0.00,0,1,186,22,10576,10665,89
leader_crash_restart,0.00,0,1,188,22,10644,10665,21
leader_crash_restart,0.00,0,1,189,22,10674,10765,91
leader_crash_restart,0.00,0,1,190,22,10758,10772,14
leader_crash_restart,0.00,0,1,192,22,10789,10884,95
leader_crash_restart,0.00,0,1,191,22,10759,10884,125
leader_crash_restart,0.00,0,1,193,22,10856,10884,28
leader_crash_restart,0.00,0,1,195,22,10940,10965,25
leader_crash_restart,0.00,0,1,194,22,10887,10965,78
leader_crash_restart,0.00,0,1,197,22,10970,11061,91
leader_crash_restart,0.00,0,1,196,22,10968,11062,94
leader_crash_restart,0.00,0,1,198,22,10972,11062,90
leader_crash_restart,0.00,0,1,200,22,11151,11174,23
leader_crash_restart,0.00,0,1,199,22,11149,11174,25
leader_crash_restart,0.00,0,1,201,22,11153,11174,21
leader_crash_restart,0.00,0,1,203,22,11182,11248,66
leader_crash_restart,0.00,0,1,202,22,11179,11249,70
leader_crash_restart,0.00,0,1,204,22,11184,11249,65
leader_crash_restart,0.00,0,1,206,22,11263,11380,117
leader_crash_restart,0.00,0,1,205,22,11261,11380,119
leader_crash_restart,0.00,0,1,207,22,11265,11380,115
leader_crash_restart,0.00,0,1,209,22,11444,11464,20
leader_crash_restart,0.00,0,1,208,22,11443,11464,21
leader_crash_restart,0.00,0,1,210,22,11446,11482,36
leader_crash_restart,0.00,0,1,212,22,11475,11559,84
leader_crash_restart,0.00,0,1,211,22,11474,11559,85
leader_crash_restart,0.00,0,1,213,22,11527,11559,32
leader_crash_restart,0.00,0,1,214,22,11608,11668,60
leader_crash_restart,0.00,0,1,216,22,11656,11689,33
leader_crash_restart,0.00,0,1,215,22,11655,11689,34
leader_crash_restart,0.00,0,1,218,22,11737,11765,28
leader_crash_restart,0.00,0,1,217,22,11690,11765,75
leader_crash_restart,0.00,0,1,219,22,11737,11765,28
leader_crash_restart,0.00,0,1,221,22,11767,11872,105
leader_crash_restart,0.00,0,1,220,22,11767,11872,105
leader_crash_restart,0.00,0,1,222,22,11771,11872,101
leader_crash_restart,0.00,0,1,224,22,11949,11968,19
leader_crash_restart,0.00,0,1,223,22,11949,11969,20
leader_crash_restart,0.00,0,1,225,22,11952,11969,17
leader_crash_restart,0.00,0,1,227,22,11979,12073,94
leader_crash_restart,0.00,0,1,226,22,11979,12073,94
leader_crash_restart,0.00,0,1,228,22,11982,12073,91
leader_crash_restart,0.00,0,1,230,22,12160,12174,14
leader_crash_restart,0.00,0,1,229,22,12160,12174,14
leader_crash_restart,0.00,0,1,232,22,12191,12273,82
leader_crash_restart,0.00,0,1,233,22,12191,12273,82
leader_crash_restart,0.00,0,1,231,22,12163,12273,110
leader_crash_restart,0.00,0,1,234,22,12344,12370,26
leader_crash_restart,0.00,0,1,236,22,12372,12462,90
leader_crash_restart,0.00,0,1,235,22,12372,12462,90
leader_crash_restart,0.00,0,1,237,22,12375,12462,87
leader_crash_restart,0.00,0,1,239,22,12554,12582,28
leader_crash_restart,0.00,0,1,238,22,12554,12582,28
leader_crash_restart,0.00,0,1,240,22,12557,12582,25
leader_crash_restart,0.00,0,1,242,22,12584,12664,80
leader_crash_restart,0.00,0,1,241,22,12584,12664,80
leader_crash_restart,0.00,0,1,243,22,12589,12664,75
leader_crash_restart,0.00,0,1,245,22,12666,12875,209
leader_crash_restart,0.00,0,1,244,22,12666,12876,210
leader_crash_restart,0.00,0,1,246,22,12670,12876,206
leader_crash_restart,0.00,0,1,248,22,13048,13076,28
leader_crash_restart,0.00,0,1,247,22,13048,13077,29
leader_crash_restart,0.00,0,1,249,22,13052,13077,25
leader_crash_restart,0.00,0,1,251,22,13079,13179,100
leader_crash_restart,0.00,0,1,250,22,13079,13179,100
leader_crash_restart,0.00,0,1,252,22,13082,13179,97
leader_crash_restart,0.00,0,1,254,22,13261,13281,20
leader_crash_restart,0.00,0,1,253,22,13260,13281,21
leader_crash_restart,0.00,0,1,255,22,13263,13281,18
leader_crash_restart,0.00,0,1,257,22,13291,13374,83
leader_crash_restart,0.00,0,1,256,22,13291,13374,83
leader_crash_restart,0.00,0,1,258,22,13295,13374,79
leader_crash_restart,0.00,0,1,259,22,13376,13488,112
leader_crash_restart,0.00,0,1,261,22,13473,13573,100
leader_crash_restart,0.00,0,1,260,22,13472,13573,101
leader_crash_restart,0.00,0,1,262,22,13557,13573,16
leader_crash_restart,0.00,0,1,264,22,13654,13663,9
leader_crash_restart,0.00,0,1,263,22,13587,13663,76
leader_crash_restart,0.00,0,1,265,22,13655,13663,8
leader_crash_restart,0.00,0,1,267,22,13665,13693,28
leader_crash_restart,0.00,0,1,266,22,13665,13694,29
leader_crash_restart,0.00,0,1,268,22,13668,13694,26
leader_crash_restart,0.00,0,1,270,22,13696,13773,77
leader_crash_restart,0.00,0,1,269,22,13695,13773,78
leader_crash_restart,0.00,0,1,271,22,13699,13773,74
leader_crash_restart,0.00,0,1,273,22,13777,13866,89
leader_crash_restart,0.00,0,1,272,22,13776,13867,91
leader_crash_restart,0.00,0,1,274,22,13780,13867,87
leader_crash_restart,0.00,0,1,276,22,13958,13997,39
leader_crash_restart,0.00,0,1,275,22,13958,13997,39
leader_crash_restart,0.00,0,1,277,22,13961,13997,36
leader_crash_restart,0.00,0,1,279,22,14039,14159,120
leader_crash_restart,0.00,0,1,278,22,14039,14159,120
leader_crash_restart,0.00,0,1,280,22,14042,14159,117
leader_crash_restart,0.00,0,1,282,22,14221,14290,69
leader_crash_restart,0.00,0,1,281,22,14221,14291,70
leader_crash_restart,0.00,0,1,283,22,14223,14291,68
leader_crash_restart,0.00,0,1,285,22,14302,14395,93
leader_crash_restart,0.00,0,1,284,22,14302,14396,94
leader_crash_restart,0.00,0,1,286,22,14305,14396,91
leader_crash_restart,0.00,0,1,288,22,14484,14590,106
leader_crash_restart,0.00,0,1,287,22,14484,14590,106
leader_crash_restart,0.00,0,1,289,22,14486,14590,104
leader_crash_restart,0.00,0,1,291,22,14666,14773,107
leader_crash_restart,0.00,0,1,290,22,14666,14773,107
leader_crash_restart,0.00,0,1,292,22,14667,14773,106
leader_crash_restart,0.00,0,1,294,22,14847,14894,47
leader_crash_restart,0.00,0,1,293,22,14847,14894,47
leader_crash_restart,0.00,0,1,295,22,14849,14894,45
leader_crash_restart,0.00,0,1,297,22,14929,14978,49
leader_crash_restart,0.00,0,1,296,22,14928,14978,50
leader_crash_restart,0.00,0,1,298,22,14930,14978,48
leader_crash_restart,0.00,0,1,300,22,15010,16465,1455
leader_crash_restart,0.00,0,1,299,22,15009,16465,1456
leader_crash_restart,0.00,0,1,302,35,16393,16465,72
leader_crash_restart,0.00,0,1,301,22,15011,16465,1454
